MSI_DO_YOU_AGREE	동의 하십니까?
MSI_SERVER_CONNECTION_FAILED	서버 연결 실패
MSI_UNABLE_TO_CONNECT_SERVER	서버와 연결이 끊어졌습니다.
MSI_BANNED	서버와 연결이 끊어졌습니다!
MSI_SERVER_OFF	서버 종료됨
MSI_DOUBLE_LOGIN_PROHIBITED	같은 계정으로 다른 사용자가 로그인 하였습니다.
MSI_INCORRECT_USERID	등록되지 않은 계정입니다. 다시 확인 바랍니다.
MSI_INCORRECT_PASSWORD	입력하신 비밀번호가 올바르지 않습니다.
MSI_ID_EXPIRED	본 ID 는 사용기간이 만료 되었습니다
MSI_ACCESS_DENIED	서버 접근 거부
MSI_CHARACTER_NAME_ALREADY_EXISTS	같은 캐릭터 이름이 있습니다.
MSI_CHARACTER_CREATION_DENIED	캐릭터 생성 거부됨
MSI_CANNOT_DELETE_CHARACTER	캐릭터 삭제 거부
MSI_ENTER_ROOM_TITLE	방제목를 입력하세요.
MSI_BAD_SENTANGE	불량단어가 검출되었습니다.
MSI_ENTER_PASSWORD	암호를 입력하세요.
MSI_Enter_Password_more_than_4_char	암호를 영문 4자 이상 입력하세요.
MSI_DO_YOU_REALLY_WANT_TO_QUIT	종료 하시겠습니까?
MSI_NAME_MUST_EXCEED_4_CHAR	4자 이상 입력해주세요. 사용자 계정이 없으신분들은 왼쪽 하단의 [신청] 버튼을 눌러 계정을 만드시기 바랍니다.
MSI_DELETE_CHARACTER	한 번 삭제된 캐릭터 및 관련 정보는      다시 복구되지 않습니다.                                 캐릭터를 삭제하시겠습니까?
MSI_BAD_NAME	불량단어가 검출되었습니다.
MSI_ENTER_NAME_MORE_THAN_4_CHAR	이름을 입력해 주세요.(한글 2자 영문 4자 이상)
MSI_LIST_COMMAND	명령어 일람: /h
MSI_EFFECT_ON	이펙트 On
MSI_EFFECT_OFF	이펙트 Off
MSI_VOLUME_OF_SOUND	사운드 볼륨
MSI_VOLUME_OF_BGM	배경음악 볼륨
MSI_SOUND_ON	효과음 On
MSI_SOUND_OFF	효과음 Off
MSI_FRAME_SKIP_ON	프레임스킵 On
MSI_FRAME_SKIP_OFF	프레임스킵 Off
MSI_BGM_ON	배경음악 On
MSI_BGM_OFF	배경음악 Off
MSI_EXPLAIN_HELP	/h or /help: 명령어 일람
MSI_EXPLAIN_WHO	/w or /who or /접속자 or /누구: 현재 접속자수 보기
MSI_EXPLAIN_MUSIC	/음악 : 배경음악 On Off
MSI_EXPLAIN_SOUND	/효과음 : 효과음 On Off
MSI_EXPLAIN_EFFECT	/이펙트 : 이펙트 On Off
MSI_EXPLAIN_POS	/좌표 or /장소: 현재 위치 표시
MSI_EXPLAIN_FRAMESKIP	/skip : 프래임스킵 On Off
MSI_EXPLAIN_SOUNDVOLUME	/v (0~127): 효과음 볼륨조정
MSI_EXPLAIN_BGMVOLUME	/bv (0~127): 배경음악 볼륨조정
MSI_EXPLAIN_SAYISOLATION	/ex (캐릭터이름) or /차단 (캐릭터이름) : 해당캐릭터에 대해 귓말차단
MSI_EXPLAIN_LIST_SAYISOLATION_CHAR	/ex or /차단 : 귓말차단 캐릭터 리스트
MSI_EXPLAIN_SAY_PERMIT	/in (캐릭터이름) or /해제 (캐릭터이름) : 해당캐릭터에 대해 귓말허용
MSI_EXPLAIN_SAY_PERMITALL	/inall or /해제전부 : 모두에게 귓말허용
MSI_EXPLAIN_SAY_ISOLATEALL	/exall or /차단전부 : 모두에게 귓말차단
MSI_EXPLAIN_TIP1	다른유저 캐릭터를 마우스 오른버튼을 누르고 있는 상태에서 왼버튼으로 클릭하면 그캐릭터이름이 귓말콤보박스에 저장됩니다.
MSI_EXPLAIN_TIP2	단축아이탬창(F12) 소비장비 아이템을 드래그한후 사용하세요. 사용키(F1F2F3F4F5F6F7F8F9)
MSI_NO_SAME_SENTANCE	같은말을 3번이상 연속해서 전송할 수 없습니다.
MSI_NO_SEND_BECAUSE_INSULT	불량단어 검출로 전송이 중단 되었습니다.
MSI_CAN_DRAG_ITEM_OLNY_ONETIME	같은아이템은 한번만 올릴수 있습니다.
MSI_CANT_GET_ITEM_BECAUSE_WEIGHT	무게가 초과하여 아이템을 가질 수 없습니다.
MSI_CANT_GET_ITEM	아이템을 가질 수 없습니다.
MSI_DEAL_SECCESS	거래가 잘 이루어졌습니다.
MSI_INSUFFICIENT_MONEY	돈이 부족합니다.
MSI_OVER_WEIGHT	무게가 초과 되었습니다.
MSI_DEAL_FAIL	거래가 실패 했습니다.
MSI_REFUSE_HEAR_ALL	모두에게 귓말거부상태로됨
MSI_REQ_REFUSE_HEAR_ALL_FAIL	모두에게 귓말거부요청 실패함
MSI_HEAR_ALL	모두에게 귓말가능상태가됨
MSI_REQ_HEAR_ALL_FAIL	모두에게 귓말가능요청 실패함
MSI_NO_REFUSE_HEAR_LIST	귓말 거부 리스트가 없습니다
MSI_REFUSE_HEAR_LIST	-귓말 거부 리스트-
MSI_ROOM_IS_MADE	방이 잘 만들어 졌습니다.
MSI_TOO_MANY_ROOM	방갯수가 허용갯수를 초과 하였습니다.
MSI_SAME_ROOM_TITLE	같은 방제목이 있습니다.
MSI_TOO_MANY_PEOPLE_IN_ROOM	인원초과로 방에 들어갈 수 없습니다.
MSI_YOU_HAVE_BANNED_FROM_THE_ROOM	강제로 퇴장된 방입니다.
MSI_REJECT_DEAL	교환요청을 거절 했습니다.
MSI_TOO_FAR_TO_DEAL	교환가능거리를 벗어났습니다.
MSI_CHARACTER_IS_NOT_EXIST	해당 캐릭터가 없습니다.
MSI_CHARACTER_IS_DEALING	다른캐릭터와 교환중입니다.
MSI_CHARACTER_IS_OVER_WEIGHT	상대 캐릭터 중량초과로 올려놓을 수 없습니다.
MSI_DEAL_IS_CANCELED	거래가 취소 되었습니다.
MSI_DEAL_SUCCESS	아이템 교환이 잘 되었습니다.
MSI_DEAL_FAILED	아이템 교환이 실패 하였습니다.
MSI_PARTY_MAKE_SUCCEED	파티가 만들어졌습니다.
MSI_SAME_PARTY_NAME	같은 파티이름이 있습니다.
MSI_YOU_ARE_ALREADY_IN_PARTY	이미 파티에 속해있습니다.
MSI_CHARACTER_IS_ALREADY_IN_PARTY	다른파티에 가입되어 있습니다.
MSI_CHARACTER_REJECT_JOIN	파티가입을 거부했습니다.
MSI_CHARACTER_ACCEPT_JOIN	파티가입을 수락했습니다.
MSI_TOO_MANY_PEOPLE_IN_PARTY	파티정원을 초과했습니다.
MSI_YOU_LEAVE_FROM_PARTY	파티에서 탈퇴하였습니다.
MSI_SEND_TO_ALL	전체에게 보냄
MSI_SEND_TO_PARTY	파티에게 보냄
MSI_REQ_DEAL_WITH	님과의 거래요청
MSI_REQ_JOIN_PARTY	님 파티에 가입요청
MSI_ROOM_PRIVATE	비공개 : 
MSI_ROOM_PUBLIC	공개 : 
MSI_RESTART_MSG	마지막 체크지점부터 시작하려면 '재시작'을 캐릭터 선택으로 돌아가려면 '종료'를 눌러주세요.
MSI_SELECT_DEAL_TYPE	원하는 거래를 선택하세요.
MSI_SUGGEST_DEAL	님이 거래를 요청했습니다.
MSI_SUGGEST_JOIN_PARTY	 파티에서 초청 메시지가 왔습니다. 합류하겠습니까?
MSI_INVALID_COMMAND	명령이 틀렸습니다.
MSI_LEAVE_PARTY	탈퇴하기
MSI_EXPEL	제명시키기
MSI_MSG	쪽지보내기
MSI_1ON1	1:1 대화
MSI_CHARACTER_INFO	정보
MSI_PARTY_SETTING	파티설정
MSI_FRIEND	친구
MSI_PARTY	파티
MSI_EQUIPED_ITEM	장착아이템
MSI_STATUS	스테이터스
MSI_ITEM	소지아이템
MSI_EXPLAIN_PARTY	/결성 [파티이름] : 파티결성 /탈퇴 : 파티탈퇴
MSI_EXPLAIN_TIP3	자신이 파티리더일때 캐릭터를 오른버튼으로 클릭하면 파티에 가입요청하기 메뉴가 뜹니다.
MSI_RESTORE	회복
MSI_ATTACK	공격
MSI_SUPPORT	보조
MSI_ALL	전체
MSI_WEAPON	무기
MSI_DEFENCE	방어
MSI_WATER	수
MSI_EARTH	지
MSI_FIRE	화
MSI_WIND	풍
MSI_EQUIPITEM_OLNY_ONE	같은 종류의 장비 아이템은 한 번에 한 개만 살 수 있습니다.
MSI_ONLY_16BIT_WHEN_WINDOWMODE	창모드에서 실행 할때는 16비트 컬러로 맞춰주세요.
MSI_PLEASE_BE_PATIENT	잠시만 기다려 주세요.
MSI_WAITING_RESPONSE_FROM_SERVER	잠시만 기다려 주세요.
MSI_MAKING_CHARACTER	잠시만 기다려 주세요.
MSI_DELETING_CHARACTER	잠시만 기다려 주세요.
MSI_MAKING_ROOM	방 만들기
MSI_CHANGE_ROOM_SETTING	방셋팅 바꾸기
MSI_BAN	강퇴시키기
MSI_GIVE_GIVE_ROOM_POWER	방장권한 주기
MSI_SEE_INFORMATION_OF_CHARACTER	정보보기
MSI_CHAT_ROOM	대화방
MSI_COUNT_UNIT_OF_PEOPLE	명
MSI_EXPLAIN_SIT	/앉기 or /sit : 앉기. 앉아있을때 서기
MSI_EXPLAIN_STAND	/서기 or /stand : 서기. 서있을때 앉기
MSI_EXPLAIN_MAKE_CHAT	/채팅방 or /chat : 채팅방 만들기창 띄우기
MSI_EXPLAIN_EXIT_CHAT_ROOM	/q : 채팅방 나가기.
MSI_EXPLAIN_DEAL	/거래 [캐릭터이름] or /교환 [캐릭터이름] or /deal [캐릭터이름] : 해당 캐릭터와 거래요청
MSI_EXPLAIN_ORGANIZE_PARTY	/결성 [파티이름] or /organize [파티이름] : 파티결성
MSI_EXPLAIN_LEAVE_PARTY	/탈퇴 or /leave : 파티 탈퇴
MSI_EXPLAIN_EXPEL_PARTY_MEMBER	/제명 [캐릭터이름] or /expel [캐릭터이름] : 해당캐릭터를 파티에서 제명시킴
MSI_EXPLAIN_TIP4	[Alt] + [End] : 플레이어 hp/sp 게이지 On Off
MSI_EXPLAIN_TIP5	[Alt] + [Home] : 지면 커서 표시 On Off
MSI_EXPLAIN_TIP6	[Insert] : 앉기 서기
MSI_YOU_RECEIVE_MVP_ITEM	MVP가 되셨습니다!! MVP 아이템은 
MSI_YOU_RECEIVE_MVP_ITEM2	 !!
MSI_YOU_RECEIVE_MVP_EXP	MVP가 되셨습니다!! 특별경험치 
MSI_YOU_RECEIVE_MVP_EXP2	 획득!!
MSI_YOU_THROW_MVPITEM	MVP가 되셨습니다만 무게초과로 MVP 아이템을 가질 수 없었습니다!!
MSI_NOT_EXIST_CHARACTER	 없는 캐릭터 이름 입니다.
MSI_NO_RECEIVE_MODE	 수신 거부 상태입니다.
MSI_NO_RECEIVE_MODE_FOR_ALL	 모든 캐릭터에 대해 수신 거부 상태 입니다.
MSI_SUCCESS_DISCONNECT_CHARACTER	캐릭터 접속끊기 성공.
MSI_FAIL_DISCONNECT_CHARACTER	캐릭터 접속끊기 실패.
MSI_GET_ITEM	%s %d 개 획득
MSI_EXPLAIN_TIP7	[Alt] + [=] : 알파벳 간격이 넓어졌을때 되돌리기.
MSI_EXPLAIN_TIP8	[F10] : 채팅창 크기조정 [Alt] + [F10] : 채팅창 On Off
MSI_EXPLAIN_TIP9	귓속말 하는법 : 채팅창 왼쪽 입력란에 캐릭터이름을 입력하고 오른쪽 입력란에 말을 입력하면 됩니다. TAB키로 두입력란 사이로 커서를 이동할 수 있습니다.
MSI_EXPLAIN_TIP10	/! /? /기쁨 /하트 /땀 /아하 /짜증 /화 /돈 /... /가위 /바위 /보 : Alt + (1~9) Ctrl + (-=\\) 에 대응되는 명령어 입니다.
MSI_EXPLAIN_TIP11	파티원에게 말하는법 : 말의 제일앞에 '%'를 붙이면 파티원에게 말이 갑니다. (예: \"%안녕\")
MSI_NOT_ENOUGH_SKILLLEVE1	스킬레벨이 부족합니다. 교환 불능.
MSI_NOT_ENOUGH_SKILLLEVE2	스킬레벨이 부족합니다. 이모션 불능.
MSI_NOT_ENOUGH_SKILLLEVE3	스킬레벨이 부족합니다. 앉기 불능.
MSI_NOT_ENOUGH_SKILLLEVE4	스킬레벨이 부족합니다. 채팅방만들기 불능.
MSI_NOT_ENOUGH_SKILLLEVE5	스킬레벨이 부족합니다. 파티만들기 불능
MSI_NOT_ENOUGH_SKILLLEVE6	스킬레벨이 부족합니다. 외치기 불능
MSI_NOT_ENOUGH_SKILLLEVE7	스킬레벨이 부족합니다. pk 불능
MSI_ITEMS_FOR_BUY	사고자하는 품목
MSI_ITEM_STORE	아이템 상점
MSI_ITEMS_FOR_SELL	팔고자하는 품목
MSI_ITEMS_THAT_IS_STORED	보관아이템
MSI_ITEM_IS_EQUIPED	 장비가 장착 되었습니다.
MSI_ITEM_IS_REMOVED	 장비가 해제 되었습니다.
MSI_ADD_TO_WHISPER_CHAR_LIST	귓말리스트에 이름넣기
MSI_EXPLAIN_TIP12	스크린샷 찍는법 : [Print Screen]키나 [Scroll Lock]키를 누르면 됩니다.
MSI_TIPOFTHEDAY	오늘의 팁
MSI_DIDYOUKNOW	^3850a0알고 계셨습니까... ^000000  //^709fed
MSI_SHOWTIPSATSTARTUP	시작할때 열기
MSI_EXPLAIN_OPENTIP	/tip : 오늘의팁 열기
MSI_NUMPEOPLE	현재 접속자 %d명
MSI_USERGETINTHEROOM	(%s)님이 입장 하였습니다.
MSI_USERGETOUTOFTHEROOM	(%s)님이 퇴장 하였습니다.
MSI_USERGETOUTOFTHEROOMBYFORCE	(%s)님이 강제 퇴장 되었습니다.
MSI_EA	 %d 개
MSI_EA2	%s : %d 개
MSI_EA3	%s %s : %d 개
MSI_ITEMSYOUCANSELL	팔 수 있는 품목
MSI_SHOPITEMS	상점에서 파는 품목
MSI_NOWHERE	알 수 없는곳
MSI_CLIENTTYPEMISMATCH	서버와 언어가 맞지 않습니다.
MSI_CLOSEEQUIPWND	아이템을 버릴려면 장비창을 닫으세요.
MSI_ENGLISHONLY	영어만 됩니다.
MSI_NOTSUPPORTEDYET	지금은 지원되지 않습니다.
MSI_NOWHISPERLIST	귓말 리스트가 없습니다.
MSI_WHISPERIGNORESUCCESS	 에게 귓말거부상태로됨
MSI_WHISPERIGNOREFAILED1	 에게 귓말거부 요청실패함
MSI_WHISPERIGNOREFAILED2	 에게 귓말거부 요청실패함 (인원초과)
MSI_WHISPERNOIGNORESUCCESS	 에게 귓말가능상태로됨
MSI_WHISPERNOIGNOREFAILED1	 에게 귓말가능 요청실패함
MSI_WHISPERNOIGNOREFAILED2	 에게 귓말가능 요청실패함 (인원초과)
MSI_NO_SPACE_IN_NAME	이름의 처음과 마지막에는 공백문자를 사용할 수 없습니다.
MSI_ROOM_PRIVATE2	비공개
MSI_ROOM_PUBLIC2	공개
MSI_USESKILL_FAIL_SP_INSUFFICIENT	SP가 부족합니다.
MSI_USESKILL_FAIL_HP_INSUFFICIENT	HP가 부족합니다.
MSI_NOT_ENOUGH_SKILLLEVE8	스킬사용 실패.
MSI_FAIL_STEAL	훔치기 실패.
MSI_EXCHANGE	교환창
MSI_FAIL_POISON	독걸기 실패.
MSI_ID_MISMATCH	이 아이디로는 이 서버에 접속할 수 없습니다.
MSI_SPEEDUP	스피드가 향상되었습니다.
MSI_SPEEDDOWN	스피드가 감소되었습니다.
MSI_EXPLAIN_TIP13	/기억 : 워프할 장소 기억(워프 스킬이 있는경우)
MSI_RANDOM_POS	임의의 위치
MSI_SELECTWHERETOWARP	워프 할 위치를 선택하세요.
MSI_NOTENOUGHSKILLLEVEL	스킬레벨이 부족합니다.
MSI_NO_STORED_PLACE_TO_WARP	저장된 워프할 장소가 없습니다.
MSI_NOWARPSKILL	워프 관련 스킬이 없습니다.
MSI_WARPPOINTSTORED	워프 장소로 저장됨.
MSI_CANCEL	취소
MSI_SKILLINTERVAL	스킬 사용후 시간이 충분히 지나지 않았습니다.
MSI_CANT_GET_ITEM_BECAUSE_COUNT	한번에 가질 수 있는 아이템 종류수를 초과하여 아이템을 가질 수 없습니다.
MSI_INSUFFICIENT_OVER_COUNT	아이템 최대 종류수를 초과 하였습니다.
MSI_MERCHANTITEM	수레아이템
MSI_CARTOFF	수레 벗기
MSI_MERCHANTSHOPMAKER	노점 개설
MSI_ENTER_SHOP_TITLE	노점이름을 입력하세요.
MSI_ITEM_MY_STORE	나의 노점
MSI_ITEM_MERCHANT_STORE	상인 아이템 상점
MSI_ITEMS_FOR_BUY_FROM_MERCHANT	상인에게 사고자하는 품목
MSI_FAIL_BUY_ITEM_FROM_MERCHANT	%s 구입 실패 %s
MSI_INSUFFICIENT_STOCK	재고 부족.
MSI_ITEM_IS_SOLD	%s %d 개 팔림.
MSI_MERCHANTMIRRORITEM	노점에서 팔 수 있는 아이템
MSI_SKILL_FAIL_MONEY	제니가 부족해서 스킬을 사용 할 수 없습니다.
MSI_SELECTTARGET	사용할 대상을 선택하세요
MSI_EXPLAIN_TIP14	/pk on : pk On /pk off : pk Off
MSI_STREETSHOP	노점
MSI_OPENCARTWINDOW	수레 아이템 [Alt+W]
MSI_BASICINFOWND	기본정보
MSI_USESKILL_FAIL_NOT_SUITABLE_WEAPON	현재 무기로는 스킬을 사용할 수 없습니다.
MSI_FAIL_BUY_ITEM_FROM_MERCHANT_NO_STOCK	%s 사기 실패 재고 부족 현재 재고 %d 개.
MSI_SPEEDHACK	서버와 동기화가 틀려 연결이 끊어졌습니다.
MSI_ERR_ATTACK_ARROW	화살을 장착하세요
MSI_ERR_ATTACK_WEIGHT	중량과다로 공격이나 스킬을 사용할 수 없습니다.
MSI_ERR_SKILL_WEIGHT	중량과다로 스킬을 사용할 수 없습니다.
MSI_MSG_ARROW_EQUIPMENT_SUCCESS	화살이 장착되었습니다.
MSI_NEED_REDJAMSTONE	레드젬스톤이 필요합니다.
MSI_NEED_BLUEJAMSTONE	블루젬스톤이 필요합니다.
MSI_DESC_STR	힘 파라메터
MSI_DESC_AGI	민첩성 파라메터
MSI_DESC_VIT	체력 파라메터
MSI_DESC_INT	지력 파라메터
MSI_DESC_DEX	손재주 파라메터
MSI_DESC_LUK	운 파라메터
MSI_DESC_ATK	공격력
MSI_DESC_DEF	방어력
MSI_DESC_HIT	명중률
MSI_DESC_CRI	필살공격률
MSI_DESC_GUILD	소속길드
MSI_DESC_POINT	각 파라메터 레벨업에 사용되는 포인트
MSI_DESC_MATK	마법공격력
MSI_DESC_MDEF	마법방어력
MSI_DESC_FLEE	회피율
MSI_DESC_ASPD	공격스피드
MSI_PC_OVERFLOW	지역당 수용인원 초과로 접속할 수 없습니다.
MSI_OPTIONWND	옵션
MSI_ID_EMAIL_CONFIRM_NEEDED	E-MAIL 인증이 되지않았거나 블럭된 계정입니다.
MSI_INCORRECT_LOGIN_PASSWORD	비밀번호가 틀립니다.
MSI_SELECT_HAIR_STYLE	머리모양 선택
MSI_ATK	공격력
MSI_DEF	방어력
MSI_ATTACK_SNAP_ON	공격스냅 On
MSI_ATTACK_SNAP_OFF	공격스냅 Off
MSI_SKILL_SNAP_ON	스킬스냅 On
MSI_SKILL_SNAP_OFF	스킬스냅 Off
MSI_EXPLAIN_SNAP	/스냅 or /snap: 몬스터 공격시 스냅 On Off  /스킬스냅 or /skillsnap: 스킬로 몬스터 공격시 스냅 On Off  /아이템스냅 or /itemsnap: 아이템 주울때 스냅 On Off
MSI_ITEM_SNAP_ON	아이템스냅 On
MSI_ITEM_SNAP_OFF	아이템스냅 Off
MSI_SNAP	스냅
MSI_CANT_GET_ITEM_OVERCOUNT_ONEITEM	한가지 아이템을 3만개 이상 가질수 없습니다.
MSI_CANT_DELETE_CHARACTER_OVER_30_LEVEL	레벨 30이상의 캐릭터는 삭제할 수 없습니다. 삭제를 원하시면 관계자에게 문의 하세요.
MSI_FAIL_BUY_ITEM_ITEM_EXCHANGING	아이템 교환중에는 아이템을 사고 팔 수 없습니다.
MSI_STALL_NAME	상점명
MSI_SKILLLIST	스킬목록
MSI_SKILLPOINT	스킬포인트 : %d
MSI_USESKILL_FAIL	스킬사용 실패
MSI_PASSIVE	패시브
MSI_EXPDIV1	각자 취득
MSI_EXPDIV2	균등하게 분배
MSI_ITEMCOLLECT1	각자 취득
MSI_ITEMCOLLECT2	파티 전체 공유
MSI_PARTYSETTING	파티 설정
MSI_HOWEXPDIV	경험치 분배방식
MSI_HOWITEMCOLLECT	아이템 수집방식
MSI_ONLY_PARTYMASTER	파티 리더만 설정할 수 있습니다.
MSI_NOQUESTION_ITEMCOUNT	아이템 갯수 안물어보기
MSI_CHARARATER_DELETE_COUNT	^ff0000%d^000000 초 후에 캐릭터가 지워집니다. 취소 하려면 취소 버튼을 누르세요.
MSI_MAXEXCHANGE_IS_10_KIND	교환할 수 있는 최대 아이템 갯수는 10가지 입니다.
MSI_LIMIT_AGE	이서버를 이용할 수 없는 나이입니다.
MSI_ENTER_EMAIL	이메일 주소를 입력하세요.
MSI_ENTER_EMAIL_TOOLTIP	이메일 주소 입력하기
MSI_CANNOT_DELETE_CHARACTER_EMAIL	이메일 주소가 틀려서 캐릭터가 삭제 되지 않았습니다.
MSI_ENTER_PEOPLE_REG_NUMBER	계정 비밀번호를 입력하세요.
MSI_CANNOT_DELETE_CHARACTER_PEOPLE_REG_NUMBER	비밀번호가 틀려서 캐릭터가 삭제 되지 않았습니다.
MSI_CANT_SELL_OVER_15	한번에 15가지 이상의 아이템을 팔 수 없습니다.
MSI_UNDER_AGE	나이제한 때문에 이계정으로 이서버에 접속할 수 없습니다.
MSI_NO_RECOVER_OVERWEIGHT	무게가 50 퍼센트 이상일때는 HP SP가 자연적으로 회복이 되지 않습니다.
MSI_NO_ATTACK_OVERWEIGHT	무게가 90 퍼센트 이상일때는 공격과 스킬을 사용할 수 없습니다.
MSI_NO_RECOVER_OVERWEIGHT_RELEASED	HP SP가 자연적으로 회복이 가능한 상태가 되었습니다.
MSI_NO_ATTACK_OVERWEIGHT_RELEASED	공격과 스킬이 가능한 상태가 되었습니다.
MSI_INVALID_VERSION	서버 점검중입니다.
MSI_ITEM_IS_SOLD_OUT	아이템이 모두 팔렸습니다.
MSI_WRITE_CHAT_TO_FILE	채팅내용 파일로 저장하기
MSI_EXPLAIN_SAVE_CHAT	/갈무리 or /savechat : 채팅 내용 파일로 저장하기.
MSI_MAKEACCOUNT	계정 만들기
MSI_REQ_EX_LIST	수신거부하기
MSI_REQ_IN	수신거부해제하기
MSI_MISS_EFFECT_ON	미스표시 On
MSI_MISS_EFFECT_OFF	미스표시 Off
MSI_FIXED_CAMERA_ON	카메라고정 On
MSI_FIXED_CAMERA_OFF	카메라고정 Off
MSI_EXPLAIN_CAMERA_MISS	/camera : 플레이어에게 카메라고정 On Off /miss : 미스이펙트 On Off
MSI_SEE_INFORMATION_OF_SKILL	스킬정보보기
MSI_CHANGE_SKILL_NAME	스킬이름바꾸기
MSI_SPRITE_RESOLUTION	스프라이트 해상도
MSI_TEXTURE_RESOLUTION	텍스쳐 해상도
MSI_DETAILLEVELWND	디테일 조정
MSI_GET_ZENY	%s Zeny 획득
MSI_GUILDNAME	길드명
MSI_GUILDLEVEL	길드레벨
MSI_GUILD_MASTER_NAME	마스터이름
MSI_GUILD_NUM_MEMBER	조합원수
MSI_GUILD_AVG_MEMBER_LEVEL	조합원 평균레벨
MSI_GUILD_MANAGE_LAND	관리영지
MSI_GUILD_FAIR	성향
MSI_GUILD_EXP	경험치
MSI_GUILD_EMBLEM	길드엠블렘
MSI_GUILD_POINT	길드상납포인트
MSI_ALLY_GUILD	동맹길드
MSI_HOSTILITY_GUILD	적대길드
MSI_GUILDINFOMANAGE	길드정보
MSI_GUILDMEMBERMANAGE	조합원정보
MSI_GUILDPOSITIONMANAGE	직위설정
MSI_GUILDSKILL	길드스킬
MSI_GUILDBANISHEDMEMBER	추방자 리스트
MSI_GUILDNOTICE	공지사항
MSI_GUILDTOTALINFO	전체길드 리스트
MSI_WHISPERLISTWND	귓말 리스트
MSI_OPENWHISPERLISTWND	귓말창 열기
MSI_EXPLAIN_WHISPER_LIST_WND	귓말 리스트 창 여는법 : [Alt] + [H] 를 누르면 귓말 리스트 창이 열립니다.
MSI_AUTOOPENWHISPERLISTWND	자동으로 귓말창 열기
MSI_DELETE	지우기
MSI_DONTOPEN	다음부터 열리지 않음
MSI_LAST_LOGIN_TIME	마지막으로 접속한 시간
MSI_LAST_LOGIN_IP	마지막으로 접속한 IP
MSI_FRIEND_SETTING	친구 설정
MSI_DO_YOU_REALLY_WANT_DELETE	정말 지우시겠습니까?
MSI_DO_YOU_REALLY_WANT_LEAVE	정말 탈퇴하시겠습니까?
MSI_ADD_TO_FRIEND_CHAR_LIST	친구로 등록하기
MSI_AUTOOPENWHISPERLISTWND_FRIEND	친구일때 자동으로 1:1창 열기
MSI_OPEN_1ON1_WINDOW	1:1창 열기
MSI_AUTOOPEN_1ON1_WINDOW	친구가 아닐때 자동으로 1:1창 열기
MSI_WHISPER_OPEN_SOUND	1:1창 열릴때 소리로 알림
MSI_DO_YOU_REALLY_WANT_EXPEL	정말 제명시키시겠습니까?
MSI_USER_LEFT_GUILD	%s 님이 길드를 탈퇴했습니다.
MSI_REASON_LEAVE_GUILD	탈퇴사유 : %s
MSI_DISORGANIZE_GUILD_FAILURE	길드명이 일치하지 않습니다
MSI_DISORGANIZATION_REASON	길드해체사유 : %s
MSI_DELETED_ACCOUNT	해당 계정은 삭제된 아이디 입니다.
MSI_SELLPRICE	판매가 :
MSI_BAN_GUILD	%s 님이 길드에서 추방되었습니다.
MSI_REASON_BAN_GUILD	추방사유 : %s
MSI_CAN_NOT_EQUIP_ITEM	아이템을 착용할 수 없습니다.
MSI_PARTYSETTING_CHANGE_IMPOSSIBLE	파티설정을 변경할 수 없습니다.
MSI_GUILD_MAKE_SUCCESS	길드가 만들어 졌습니다.
MSI_GUILD_MAKE_ALREADY_MEMBER	이미 길드에 속해있습니다.
MSI_GUILD_MAKE_GUILD_EXIST	같은이름의 길드가 존재합니다.
MSI_SUGGEST_JOIN_GUILD	 길드에서 초청 메시지가 왔습니다. 가입하겠습니까?
MSI_CHARACTER_IS_ALREADY_IN_GUILD	다른길드에 가입되어 있습니다.
MSI_CHARACTER_REJECT_JOIN_GUILD	길드가입을 거절 했습니다.
MSI_CHARACTER_ACCEPT_JOIN_GUILD	길드가입을 수락했습니다.
MSI_TOO_MANY_PEOPLE_IN_GUILD	길드정원을 초과했습니다.
MSI_REQ_JOIN_GUILD	(%s)님 길드에 가입요청
MSI_NOT_ENOUGH_FOR_MANNER_POINT	스킬 레벨이 모자라서 매너포인트를 줄 수 없습니다.
MSI_GIVING_MANNER_POINT_SUCCESS	매너 포인트 주기 성공
MSI_YOU_USE_TODAY_ALREADY	오늘 이미 사용했습니다.
MSI_ONE_MONTH_NOT_PASSED	이캐릭터에게 지급한지 한달이 지나지 않았습니다.
MSI_RECEIVE_PLUS_MANNER_POINT	%s 님으로부터 플러스 매너 포인트를 받았습니다.
MSI_RECEIVE_MINUS_MANNER_POINT	%s 님으로부터 마이너스 매너 포인트를 받았습니다.
MSI_GIVE_PLUS_MANNER_POINT	채팅 금지 시간 줄이기(풀기)
MSI_GIVE_MINUS_MANNER_POINT	채팅 금지 시간 늘이기(걸기)
MSI_REQ_DEAL_WITH2	(%s)님과의 거래요청
MSI_REQ_JOIN_PARTY2	(%s)님 파티에 가입요청
MSI_SUGGEST_ALLY_GUILD	 길드에서 동맹요청 메시지가 왔습니다. 동맹하겠습니까?
MSI_REQALLYGUILD_ALREADY_ALLIED	이미 동맹되어 있습니다.
MSI_REQALLYGUILD_REJECT	동맹을 거절 했습니다.
MSI_REQALLYGUILD_ACCEPT	동맹을 수락 했습니다.
MSI_REQALLYGUILD_OVERSIZE	상대길드의 동맹길드의 수가 초과 되었습니다.
MSI_REQALLYMYGUILD_OVERSIZE	길드의 동맹길드의 수가 초과 되었습니다.
MSI_REQ_ALLY_GUILD	길드 동맹 요청
MSI_DISORGANIZE_GUILD_SUCCESS	길드가 성공적으로 해체 되었습니다.
MSI_DISORGANIZE_GUILD_INVALIDKEY	주민등록번호가 틀려서 길드가 해체되지 않았습니다.
MSI_DISORGANIZE_GUILD_MEMBEREXIST	길드맴버가 존재해서 길드가 해체되지 않았습니다.
MSI_REQ_HOSTILE_GUILD	길드 적대 요청
MSI_SELECT_HAIR_COLOR	머리색깔 선택
MSI_GUILD_MAKE_GUILD_NONE_ITEM	길드결성시 필요한 아이템이 없습니다.
MSI_MONSTER_INFO_WINDOW	몬스터 정보
MSI_NAME	이름
MSI_LEVEL	레벨
MSI_HP	HP
MSI_SIZE	크기
MSI_RACETYPE	종족
MSI_MDEFPOWER	MDEF
MSI_PROPERTY	속성
MSI_PROPERTY_NEUTURAL	無
MSI_PROPERTY_WATER	水
MSI_PROPERTY_EARTH	地
MSI_PROPERTY_FIRE	火
MSI_PROPERTY_WIND	風
MSI_PROPERTY_POISON	毒
MSI_PROPERTY_SAINT	聖
MSI_PROPERTY_DARK	暗
MSI_PROPERTY_MENTAL	念
MSI_PROPERTY_UNDEAD	死
MSI_CANT_MAKE_ITEM	현재는 아이템을 만들 수 없습니다.
MSI_MAKE_LIST	제조 목록
MSI_MAKE_TARGET	 만들기
MSI_REQUIRE_FOR_MAKE_TARGET	 에 필요한 재료:
MSI_MAKE_TARGET_FAIL	 만들기 실패
MSI_MAKE_TARGET_SUCCEESS	 만들기 성공
MSI_MAKE_TARGET_FAIL_MSG	%s 만들기를 실패하였습니다.
MSI_MAKE_TARGET_SUCCEESS_MSG	%s 만들기를 성공했습니다.
MSI_NOT_ENOUGH_LEVEL	레벨이 부족합니다.
MSI_TOO_HIGH_LEVEL	레벨이 너무 높습니다.
MSI_NOT_ACCEPTABLE_JOB	직업이 적합하지 않습니다.
MSI_TALKBOX_WINDOW	토키 박스 트랩 메세지
MSI_TALKBOX_WINDOW_MSG	기록할 메세지를 입력하시기 바랍니다.
MSI_SEND_TO_GUILD	길드에게 보냄
MSI_NOT_SETTLED	결제된 계정이 아닙니다. 결제 페이지로 이동하시겠습니까?
MSI_ACCOUNT_BUSY	서버가 혼잡한 관계로 잠시후 다시 시도해 주시기 바랍니다.
MSI_INFORMATION_REMAINED	지난 접속 정보가 남아 있습니다. 30초정도 지난뒤에 다시 시도해 주시기 바랍니다.
MSI_BIRDOFF	매 풀어주기
MSI_CHIKENOFF	페코페코 내리기
MSI_SIZE_SMALL	小
MSI_SIZE_MIDDLE	中
MSI_SIZE_BIG	大
MSI_DOUBLE	더블
MSI_TRIPLE	트리플
MSI_QUADROPLE	쿼드로플
MSI_LOGIN_REFUSE_BLOCKED_UNTIL	%s 까지 로그인을 금지하고 있습니다.
MSI_MANUFACTURED_NORMAL_ITEM	의 
MSI_MANUFACTURED_FIRE_ITEM	의 파이어 
MSI_MANUFACTURED_ICE_ITEM	의 아이스 
MSI_MANUFACTURED_WIND_ITEM	의 윈드 
MSI_MANUFACTURED_EARTH_ITEM	의 어스 
MSI_ACCOUNT_ADDRESS	211.239.161.246
MSI_ACCOUNT_PORT	6900
MSI_REGISTRATION_WEB_URL	http://roz.gnjoy.com/
MSI_BAN_USER	%s 사용자 강제 종료
MSI_ONE_STARPIECE	무지쎈 
MSI_TWO_STARPIECE	무지무지쎈 
MSI_THREE_STARPIECE	무무무쎈 
MSI_GUILD_KICK_REASON	길드 추방 사유
MSI_INCATTACKSPEED	 공격 속도가 증가했습니다.
MSI_DECATTACKSPEED	 공격 속도가 감소했습니다.
MSI_INCWEAPONATTACK	 무기의 공격력이 향상되었습니다.
MSI_DECWEAPONATTACK	 무기의 공격력이 감소되었습니다.
MSI_FASTPREDELAY	 시전 딜레이가 줄었습니다.
MSI_NORMALPREDELAY	 시전 딜레이가 정상으로 되었습니다.
MSI_WEAPONPROPERTYPOISON	 무기에 독속성이 부여되었습니다.
MSI_WEAPONPROPERTYSAINT	 무기에 성속성이 부여되었습니다.
MSI_WEAPONPROPERTYORIGINAL	 무기의 원래속성이 적용되었습니다.
MSI_ARMORPROPERTYSAINT	 방어구에 성속성이 부여되었습니다.
MSI_ARMORPROPERTYORIGINAL	 방어구의 원래속성이 적용되었습니다.
MSI_BARRIOR	 배리어 상태가 되었습니다.
MSI_DISAPPEARBARRIOR	 배리어 상태가 해제 되었습니다.
MSI_PERFECTDAMAGE	무기별 크기에 따른 패널티를 삭제합니다.
MSI_DISAPPEARPERFECTDAMAGE	 웨폰퍼펙션 모드가 해제 되었습니다.
MSI_OVERTHRUSTING	 무기가 파괴될 가능성이 높아진 대신 무기의 공격력이 증가하였습니다.
MSI_DISAPPEAROVERTHRUSTING	 오버트러스트 상태가 해제 되었습니다.
MSI_MAXIMIZE	 무기의 최대 성능을 끌어냅니다.
MSI_DISAPPEARMAXIMIZE	 맥시마이즈 상태가 해제 되었습니다.
MSI_SERVER_PROPERTY_NEW	[신서버] 
MSI_SERVER_USER_COUNT	(%d 명)
MSI_SERVER_INSPECTING	(점검중)
MSI_GUILD_MEMBER_STATUS_ONLINE	길드멤버 %s님이 접속하셨습니다.
MSI_GUILD_MEMBER_STATUS_OFFLINE	길드멤버 %s님이 종료하셨습니다.
MSI_GOT_EXPERIENCE_POINT	경험치 %d 얻음
MSI_GOT_JOB_EXPERIENCE_POINT	잡경험치 %d 얻음
MSI_LEFT_GUILD	길드에서 탈퇴 했습니다.
MSI_BAN_FROM_GUILD	길드에서 추방 당했습니다.
MSI_ITEM_IDENTIFY_SUCCEESS	아이템 감정 성공
MSI_ITEM_IDENTIFY_FAIL	아이템 감정 실패
MSI_ITEM_COMPOUNDING_SUCCEESS	아이템 조합 성공
MSI_ITEM_COMPOUNDING_FAIL	아이템 조합 실패
MSI_HOSTILE_GUILD_SUCCEESS	길드 적대 성공
MSI_TOO_MANY_HOSTILE_GUILD	적대 길드수 초과로 길드 적대 실패
MSI_ALREADY_REGISTERED_HOSTILE_GUILD	이미 적대 길드 입니다
MSI_ITEM_REFINING_SUCCEESS	제련이 성공적으로 되었습니다.
MSI_ITEM_REFINING_FAIL	제련이 실패하였습니다.
MSI_IMPOSSIBLE_TELEPORT_AREA	이곳에서는 순간이동이 불가능합니다.
MSI_POSSIBLE_TELEPORT_AREA	이 장소는 기억할 수 없습니다.
MSI_CANT_EXIT_NOW	지금은 종료할 수 없습니다.
MSI_POSITION	직위
MSI_JOB	직업
MSI_MEMO	메모
MSI_CONTRIBUTION	기여
MSI_EXP_CONTIRIBUTION	상납경험치
MSI_LEAVE_GUILD	길드탈퇴
MSI_EXPEL_GUILD	제명시키기
MSI_GRADE	서열
MSI_POSITION_NAME	직위명
MSI_JOIN_AUTHORITY	가입권한
MSI_PENALTY_AUTORITY	처벌권한
MSI_CONTRIBUTION_PERCENT	상납%
MSI_TITLE	제목
MSI_CONTENTS	내용
MSI_GUILD_NAME	길드이름
MSI_GUILD_LEVEL	길드레벨
MSI_GUILD_PEOPLE_COUNT	조합원수
MSI_RANKING	랭킹
MSI_ITEM_IDENTIFY	아이템 감정
MSI_ITEM_COMPOUNDING	아이템 조합
MSI_PLEASE_INPUT_WHY_LEAVING	탈퇴 사유를 입력해주세요.
MSI_PELASE_INPUT_WHY_EXPEL	추방 사유를 입력해주세요.
MSI_PLEASE_CLOSE_STORE	상점을 닫으세요.
MSI_SKILL_NAME	스킬 이름
MSI_ITEM_NAME	아이템 이름
MSI_SETTLE_WEB_URL	https://payment.ragnarok.co.kr
MSI_BAN_IP_OVERFLOW	게임방에서 사용가능한 IP개수가 모두 사용중입니다. 개인 계정으로 결제 하시겠습니까?
MSI_BAN_PAY_OUT	결제시간이 다되어 게임을 종료합니다.
MSI_NAMELENGTH_TOO_LONG	이름이 너무 깁니다. 한글 11자 영문 23자 이내로 써주십시오.
MSI_DELETE_AFTER_10_SECOND	deleted
MSI_BILLING_100	귀하는 개인 정액제 사용자입니다.
MSI_BILLING_200	귀하는 개인정량제 사용자입니다.
MSI_BILLING_300	귀하는 개인 무료 사용자입니다.
MSI_BILLING_400	귀하는 개인 무료 허용기간 사용자입니다.
MSI_BILLING_500	귀하는 게임방 정액제 사용자입니다.
MSI_BILLING_501	귀하는 게임방 정량제 사용자입니다.
MSI_BILLING_600	귀하는 게임방 무료 허용기간 사용자입니다.
MSI_BILLING_700	귀하는 게임방 무료 사용자입니다.
MSI_BILLING_800	귀하는 종량제 사이트 이용자입니다.
MSI_EMOTION_LIST	이모션 목록
MSI_VIEW_EMOTION	/이모션
MSI_EMOTION_SURPRISE	/!
MSI_EMOTION_QUESTION	/?
MSI_EMOTION_DELIGHT	/기쁨
MSI_EMOTION_THROB	/하트
MSI_EMOTION_BIGTHROB	/왕하트
MSI_EMOTION_SWEAT	/땀
MSI_EMOTION_AHA	/아하
MSI_EMOTION_FRET	/짜증
MSI_EMOTION_ANGER	/화
MSI_EMOTION_MONEY	/돈
MSI_EMOTION_THINK	/...
MSI_EMOTION_THANKS	/감사
MSI_EMOTION_KEK	/꽥
MSI_EMOTION_SORRY	/죄송
MSI_EMOTION_SMILE	/웃음
MSI_EMOTION_PROFUSELY_SWEAT	/뻘뻘
MSI_EMOTION_SCRATCH	/긁적
MSI_EMOTION_BEST	/최고
MSI_EMOTION_STARE_ABOUT	/두리번
MSI_EMOTION_HUK	/헉
MSI_EMOTION_O	/오
MSI_EMOTION_X	/엑스
MSI_EMOTION_HELP	/헬프
MSI_EMOTION_GO	/가
MSI_EMOTION_CRY	/엉엉
MSI_EMOTION_KIK	/킥킥
MSI_EMOTION_CHUP	/쪽
MSI_EMOTION_CHUPCHUP	/쪽쪽
MSI_EMOTION_HNG	/흥
MSI_EMOTION_OK	/응
MSI_SHORTCUT_LIST	단축키 목록
MSI_BAN_PAY_SUSPEND	귀하의 계정은 보류되었습니다.
MSI_BAN_PAY_CHANGE	과금 정책 변경으로 인해 일시 종료됩니다. 다시 접속하여 주시기 바랍니다.
MSI_BAN_PAY_WRONGIP	어카운트 서버에 인증된 IP와 귀하의 IP가 달라 연결을 종료합니다.
MSI_BAN_PAY_PNGAMEROOM	게임방 IP에서 개인 종량제 과금을 막기 위해 연결을 종료합니다. 개인 종량제 과금을 사용하기 위해서는 게임방IP로 등록이 되지 않은 IP를 사용해 주세요.
MSI_BAN_OP_FORCE	귀하는 운영자에 의해 강제 종료 되었습니다.
MSI_USESKILL_FAIL_WEIGHTOVER	무게가 90%를 초과하여 스킬을 사용할 수 없습니다.
MSI_NAMELESS_USER	무명
MSI_RANK_IN_TEN	축하합니다. %s님의 현재 랭킹이 %d위로 상승하였습니다.
MSI_RANK_OUT_TEN	안타깝게도 %s님의 현재 랭킹이 %d위로 하락하였습니다.
MSI_PET_INFO	Pet Info
MSI_PET_HUNGRY	만복도
MSI_PET_FRIENDLY	친밀도
MSI_CANT_OPEN_STORE_WHILE_CHAT	상점과 채팅방을 동시에 열수 없습니다.
MSI_EA4	개
MSI_SLAIN	%s 를 전투불능으로 만들었습니다.
MSI_SLAINBY	%s 님에 의해 전투불능 상태가 되었습니다.
MSI_NOT_EXIST_PET_FOOD	먹이 - '%s' 아이템이 존재하지 않습니다..
MSI_PET_FEEDING	먹이 주기
MSI_PET_PERFORMANCE	퍼포먼스
MSI_PET_RETURN_EGG	알로 되돌리기
MSI_PET_ACC_OFF	악세사리 해제
MSI_PET_SHOWINFO	Pet 상태 보기
MSI_PET_ACCESSARY	악세사리
MSI_ITEM_EQUIPED	장착됨
MSI_PET_EGG_LIST	펫 리스트
MSI_ITEM_UNEQUIPED	장착 안됨
MSI_SURE_TO_FEED_PET	정말로 먹이를 주시겠습니까?
MSI_CAN_INPUT_NUMBER_ONLY	가격을 쓰실땐 숫자(0~9)만 써주십시오.
MSI_CANT_SELL_UNIDENTIFIED_ITEM	감정되지 않은 아이템은 판매할 수 없습니다.
MSI_YOU_HAVE_FREE_ITEM_ON_SHOP	가격이 0 Zeny인 아이템이 존재합니다. 계속 하시겠습니까?
MSI_NEW_EMOTION_LIST	[새로 추가된 이모션 리스트]
MSI_BAN_JAPAN_REFUSE1	일본쪽 베타 사용자들에게 전하는 메세지. -> 겅호에서 재가입 하세요.
MSI_BAN_JAPAN_REFUSE2	일본쪽 과금이 종료된 사용자들에게 전하는 메세지. -> 돈내라. 두 번내라.
MSI_ALREADY_SAME_AID_JOINED	같은 계정의 캐릭터가 이미 가입되어있습니다.
MSI_SERVER_PROPERTY_ADULT	(%d 명) - 만18세이상
MSI_ENST_PROVOKE	 프로보크 상태가 되었습니다.
MSI_DSST_PROVOKE	 프로보크 상태가 해제되었습니다.
MSI_ENST_ENDURE	 인듀어 상태가 되었습니다.
MSI_DSST_ENDURE	 인듀어 상태가 해제되었습니다.
MSI_ENST_CONCENTRATION	 집중력 향상 상태가 되었습니다.
MSI_DSST_CONCENTRATION	 집중력 향상 상태가 해제되었습니다.
MSI_ENST_HIDING	 하이딩 상태가 되었습니다.
MSI_DSST_HIDING	 하이딩 상태가 해제되었습니다.
MSI_ENST_CLOAKING	 클로킹 상태가 되었습니다.
MSI_DSST_CLOAKING	 클로킹 상태가 해제되었습니다.
MSI_ENST_POISONREACT	 독을 반사 할 수 있는 상태가 되었습니다.
MSI_DSST_POISONREACT	 포이즌 리액트 상태가 해제되었습니다.
MSI_ENST_QUAGMIRE	 이동속도가 감소하였습니다.
MSI_DSST_QUAGMIRE	 콰그마이어 상태가 해제되었습니다.
MSI_ENST_ANGELUS	 방어력이 증가되었습니다.
MSI_DSST_ANGELUS	 안젤루스 상태가 해제되었습니다.
MSI_ENST_BLESSING	 힘과 지능, 덱스가 증가하였습니다.
MSI_DSST_BLESSING	 블레싱 상태가 해제되었습니다.
MSI_ENST_CRUCIS	 시그넘 크루시스를 사용하였습니다.
MSI_DSST_CRUCIS	 시그넘 크루시스 상태가 해제되었습니다.
MSI_ENST_SLOWPOISON	 독이 퍼지는 속도가 느려졌습니다.
MSI_DSST_SLOWPOISON	 슬로우 포이즌 상태가 해제되었습니다.
MSI_ENST_MAGNIFICAT	 SP의 회복 속도가 향상 되었습니다.
MSI_DSST_MAGNIFICAT	 마니피캇 상태가 해제되었습니다.
MSI_ENST_GLORIA	 행운이 향상되었습니다.
MSI_DSST_GLORIA	 글로리아 상태가 해제되었습니다.
MSI_ENST_LEXAETERNA	 1회 공격에 두 배 데미지를 받는 상태가 되었습니다.
MSI_DSST_LEXAETERNA	 렉스에테르나 상태가 해제되었습니다.
MSI_ENST_ADRENALINE	 공격속도가 증가하였습니다.
MSI_DSST_ADRENALINE	 공격속도가 감소하였습니다.
MSI_ENST_RIDING	 페코에 올라 탔습니다.
MSI_DSST_RIDING	 페코에서 내렸습니다.
MSI_ENST_FALCON	 팔콘을 장착하였습니다.
MSI_DSST_FALCON	 팔콘을 풀어주었습니다.
MSI_ENST_TRICKDEAD	 죽은척하기 상태가 되었습니다.
MSI_DSST_TRICKDEAD	 죽은척하기 상태가 해제되었습니다.
MSI_ENST_SHOUT	 힘이 강해졌습니다.
MSI_DSST_SHOUT	 힘이 원래대로 돌아왔습니다.
MSI_ENST_ENERGYCOAT	 에너지코트 상태가 되었습니다.
MSI_DSST_ENERGYCOAT	 에너지코트 상태가 해제되었습니다.
MSI_ENST_BROKENAMOR	 방어구가 파괴되었습니다.
MSI_DSST_BROKENAMOR	 ...
MSI_ENST_BROKENWEAPON	 무기가 파괴되었니다.
MSI_DSST_BROKENWEAPON	 ...
MSI_ENST_ILLUSION	 환영상태가 되었습니다.
MSI_DSST_ILLUSION	 환영상태가 해제되었습니다.
MSI_REFUSE_BLOCK_TEMPORARY	과금 정보 처리가 늦어지고 있어 접속이 지연되고 있습니다. 잠시 후에 다시 시도해 주시기 바랍니다.
MSI_UNEQUIP_ARROW	장착된 화살/탄환/수리검 을 해제해야합니다.
MSI_ARROW_LIST	화살 목록
MSI_CART_LIST	카트 목록
MSI_MUST_EQUIP_CART	카트를 장착한 상태여야 합니다.
MSI_CANT_MAKE_CHAT_ROOM	채팅방을 개설 할 수 없습니다.
MSI_3DAY_FREE	라그나로크 홈페이지로 접속하여 계정을 만듭니다. 처음 계정을 만드시면 3일 동안은 무료로 이용하실 수 있습니다.
MSI_CANT_USE_WHEN_SITDOWN	앉은 상태에서는 이 아이템을 사용할 수 없습니다.
MSI_BAD_MANNER_REMAIN	채팅, 스킬, 아이템 사용금지가 %d 분간 남아 있습니다.
MSI_BAD_MANNER_END	채팅, 스킬, 아이템 사용금지가 해지 되었습니다.
MSI_REF_UNEQUIP	-[장착안됨]
MSI_VERY_HUNGRY	배고픔
MSI_HUNGRY	출출함
MSI_NORMAL	보통
MSI_REPLETE	배부름
MSI_VERY_REPLETE	아주 배부름
MSI_VERY_AWKWARD	서먹서먹함
MSI_AWKWARD	어색함
MSI_FRIENDLY	친함
MSI_VERY_FRIENDLY	절친함
MSI_UNKNOWN	알수 없음
MSI_BILLING_DAY_HOUR_MINUTES	귀하는 앞으로 %일 %d시간 %d분 사용이 가능합니다.
MSI_BAN_INFORMATION_REMAINED_ANOTHER_ACCOUNT	이 계정은 이미 다른 어카운트 서버로 접속한 상태입니다.
MSI_BILLING_HOUR_MINUTES	귀하는 앞으로 %d시간 %d분 사용이 가능합니다.
MSI_BILLING_FREE_USER	귀하는 무료 사용자 입니다.
MSI_REFUSE_NONSAKRAY_ID_BLOCKED	이 계정으로 사크라이에 접속할수 없습니다.
MSI_PETNAME_IN23	펫의 이름은 영문 23, 한글 11자 이내로 정해 주세요.
MSI_PETNAME_CHANGE_ONLYONCE	이름은 단 한번만 바꿀수 있습니다. 펫 이름을 ^0000ff^0000ff %s^000000^000000 로 수정합니다. 계속 하시겠습니까?
MSI_NAMEBALLOON_TYPE	/폰트
MSI_GUILDZENY_NOT_ENOUGH	길드에 남은 제니가 부족하여 작업이 실패하였습니다.
MSI_GUILDZENY_OVER	길드가 소유할 수 있는 최대 금액을 초과하여 작업이 실패하였습니다.
MSI_MINEFFECT_ON	이펙트 간략화 On
MSI_MINEFFECT_OFF	이펙트 간략화 Off
MSI_CAPITAL	자본금
MSI_OPEN_ITEMWND_TO_THROW	아이템을 바닥에 버리려면, 아이템 창을 열어 주십시오.
MSI_ASK_PNGAMEROOM	PC방 요금이 종료하여 개인 요금제로 전환합니다. 개인 요금으로 게임을 계속 하시겠습니까?
MSI_REPLY_REMAINTIME	
MSI_INFO_REMAINTIME	
MSI_OVER_OR_LOW_MONEY	돈이 모자라거나, 가질 수 있는 최대 금액을 초과하였습니다.
MSI_PRESS_ESC_TO_RESTART	전투불능 상태가 되었습니다. esc키를 누르시면 선택창이 뜹니다.
MSI_EA_OBTAIN	  %d 개 획득
MSI_SPELL_LIST	스펠 리스트
MSI_MINEFFECT	/최소화
MSI_DAMAGED_ITEM	이 아이템은 손상되어 있습니다.
MSI_EXPLAIN_NOSHIFT	/noshift : 쉬프트를 누르지않고 힐로 적을 공격할수있게됩니다 On Off
MSI_NOSHIFT_ON	시프트를 누르지 않고도 힐로 언데드를 공격할수 있습니다 [/ns ON]
MSI_NOSHIFT_OFF	시프트를 눌러야 힐로 언데드를 공격할수 있습니다 [/ns OFF]
MSI_REFUSE_BAN_BY_DBA	MSI_REFUSE_BAN_BY_DBA
MSI_REFUSE_EMAIL_NOT_CONFIRMED	MSI_REFUSE_EMAIL_NOT_CONFIRMED
MSI_REFUSE_BAN_BY_GM	MSI_REFUSE_BAN_BY_GM
MSI_REFUSE_TEMP_BAN_FOR_DBWORK	MSI_REFUSE_TEMP_BAN_FOR_DBWORK
MSI_REFUSE_SELF_LOCK	MSI_REFUSE_SELF_LOCK
MSI_REFUSE_NOT_PERMITTED_GROUP	MSI_REFUSE_NOT_PERMITTED_GROUP
MSI_REFUSE_WAIT_FOR_SAKRAY_ACTIVE	MSI_REFUSE_WAIT_FOR_SAKRAY_ACTIVE
MSI_EXPLAIN_AURA	/aura : 오오라를 간략화 시킬수있습니다 On Off
MSI_AURA_ON	오오라가 정상적으로 표시됩니다 [오오라 ON]
MSI_AURA_OFF	오오라가 간략화되서 표시됩니다 [오오라 OFF]
MSI_PROHIBIT_LOG	채팅금지 기록 %d 회
MSI_PROHIBIT_LIST	채팅 금지 리스트
MSI_EXPLAIN_SHOWNAMETYPE	/이름표시 or /showname : 캐릭터의 이름 표시 방식을 변경합니다.
MSI_EXPLAIN_NOCTRL	/noctrl : 콘트롤을 누르지않아도 자동공격이 됩니다. On Off
MSI_NOCTRL_ON	콘트롤을 누르지 않아도 자동공격을 합니다 [/nc ON]
MSI_NOCTRL_OFF	콘트롤을 눌러야 자동공격을 합니다 [/nc OFF]
MSI_APPEND_PROHIBIT	채팅 금지 주기
MSI_ERASE_PROHIBIT	채팅 금지 완전 풀기 & 로그 삭제
MSI_REDUCE_PROHIBIT	채팅 금지 시간 줄이기(로그 삭제 안됨)
MSI_SHOWNAME_ON	폰트가 정상적으로 바뀌었습니다 [이름표시방식 1]
MSI_SHOWNAME_OFF	폰트가 가늘게 바뀌면서 파티명도 표시됩니다 [이름표시방식 2]
MSI_EXPLAIN_DORIDORI	/doridori : 연속해서 이 명령어를 쳐주면 캐릭터가 도리도리 ^^;;
MSI_BILLING_INTERNET_CAFE	인터넷 카페에서 과금을 하고 있습니다.
MSI_BILLING_BOTH	정액제 과금은 %d일 %d시간 %d분이 남았습니다.\n종량제 과금은 %d시간 %d분이 남았습니다.
MSI_EXPLAIN_BINGBING	/bingbing : 연속해서 이 명령어를 쳐주면 캐릭터가 빙글빙글 ^^;;
MSI_EXPLAIN_BANGBANG	/bangbang : 연속해서 이 명령어를 쳐주면 캐릭터가 뱅글뱅글 ^^;;
MSI_EXPLAIN_SKILLFAIL	/skillfail : 빨간색의 스킬사용 실패 메세지를 표시하지 않습니다 On Off
MSI_SKILLFAIL_ON	스킬사용 실패 메세지를 표시합니다 [/sf ON]
MSI_SKILLFAIL_OFF	스킬사용 실패 메세지를 표시하지 않습니다 [/sf OFF]
MSI_EXPLAIN_NOTALKMSG	/notalkmsg : 채팅내용을 채팅창에 표시하지 않습니다 On Off
MSI_NOTALKMSG_ON	채팅내용을 채팅창에 표시합니다 [/nm ON]
MSI_NOTALKMSG_OFF	채팅내용을 채팅창에 표시하지않습니다 [/nm OFF]
MSI_EXPLAIN_SET1	/set1 : /nc + /showname + /sf + /wi, /set2 : + /q3
MSI_EXPLAIN_FOG	/fog : FOG이펙트를 키거나 끌수있습니다 On Off
MSI_SUGGEST_COUPLE	  청혼을 해왔습니다. 승낙하시겠습니까?
MSI_HOWITEMDIV	아이템 분배 방식
MSI_ITEMDIV1	각자 취득
MSI_ITEMDIV2	균등하게 분배
MSI_KEYCRYPT	nProtect KeyCrypt
MSI_KEYCRYPT_INSTALL_KEYDRIVER	Keyboard Driver가 검출되었습니다. \n\n키보드 보안 입력을 위해 추가기능을 설치하시겠습니까?    \n\n(추가기능 설치후, 시스템 reboot 필수)
MSI_KEYCRYPT_REBOOT	설치가 완료 되었습니다. \n\n시스템을 Reboot 합니다.    
MSI_KEYCRYPT_INSTALLFAIL	설치 실패. 
MSI_KEYCRYPT_SKIPKEYCRYPT	키보드 보안을 적용하지 않고 계속합니다.
MSI_KEYCRYPT_NOKEYCRYPTFILE	키보드 보안에 필요한 파일이 존재하지 않습니다.  \n\n(npkeyc.vxd, npkeyc.sys, npkeycs.sys)
MSI_KEYCRYPT_USBKEYBOARD	USB Keyboard가 검출되었습니다. \n\n키보드 보안 입력을 위해 추가기능을 설치하시겠습니까?    \n\n(추가기능 설치후, 시스템 reboot 필수)
MSI_FINDHACK_PATH	ftp://ragnarok.nefficient.co.kr/pub/ragnarok/ragnarok0526.exe
MSI_FINDHACK_NOTINSTALLED	FindHack이 정상적으로 설치가 되어있지 않습니다. ragnarok0226.exe 를 다운로드 하여 라그나로크가 설치된 폴더에 설치해 주시기 바랍니다.(%d).
MSI_FINDHACK_HACKTOOLEXIST	해킹툴이 존재하지만 치료가 정상적으로 되지 않았습니다. 라그나로크가 실행되지 않습니다.
MSI_FINDHACK_CANTDOWNLOAD	해킹툴 진단 프로그램이 정상적으로 다운로드 되지 않았습니다. ragnarok0226.exe 를 다운로드 하여 라그나로크가 설치된 폴더에 설치해 주시기 바랍니다.
MSI_FINDHACK_NOFILE	NPX.DLL 등록에러 이거나 FindHack 구동에 필요한 파일이 없습니다. ragnarok0226.exe 를 다운로드 하여 라그나로크가 설치된 폴더에 설치해 주시기 바랍니다.
MSI_FINDHACK_EXCEPTION	예외사항이 발생했습니다. (02-3281-0361)로 문의해주세요. 리턴값(%d)
MSI_FINDHACK_EXITPRESSED	종료버튼을 클릭 하셨습니다.
MSI_FINDHACK_UPDATEFAILED	Findhack 업데이트 서버접근 실패하였습니다. 잠시 후에 다시 시도해 주시거나 그라비티 운영팀으로 연락해주시기 바랍니다.
MSI_NAMED_PET	사랑받고있는 
MSI_REPORTCOMMAND_EXPLANATION	/report or /신고 : 신고용 갈무리 파일을 저장합니다.
MSI_REPORTTEXT_HEADER	이 파일은 (주)그라비티의 운영팀에서 게임내의 부정행위나 비매너 행위에 대한\n증거자료로 사용하게 됩니다.\n문서를 다른 문서 형식으로 저장하거나 내용을 변경하여 원본과 일치하지 않게\n 될 경우 그 문서는 증거 효력을 상실하게 됩니다.
MSI_LOVE_SKILL	당신을 사랑해요 ♡
MSI_EXPLAIN_BRIGHT	화면 또는 이펙트가 밝아서 눈에 부담이 되시는분들은 모니터의 밝기를 조정해주시기바랍니다.
MSI_EXPLAIN_ALTTAB	전체화면모드가 잘안되는 경우에 게임실행후 ALT+TAB으로 화면을 전환하면 잘되는 기종도 있습니다
MSI_SERVER_PROPERTY_PAY	(%d 명) - 유료서버
MSI_SERVER_PROPERTY_FREE	(%d 명) - 무료서버
MSI_CANT_CONNECT_TO_PAY_SERVER	무료 회원은 유료 서버로 접속할 수 없습니다.
MSI_QUICKSPELL_ON	마우스 우클릭으로 F9에 저장한 스킬을 쓸수있습니다 [/q1 ON]
MSI_QUICKSPELL_OFF	마우스 우클릭으로 스킬을 사용하지 못합니다 [/q1 OFF]
MSI_EXPLAIN_QUICKSPELL	/quickspell  : 마우스 우클릭으로 F9에 저장한 스킬을 사용합니다 On Off
MSI_QUICKSPELL2_ON	마우스의 WHEEL을 사용해서 F7 과 F8에 저장한 스킬을 사용합니다 [/q2 ON]
MSI_QUICKSPELL2_OFF	마우스 WHEEL로 스킬을 사용하지 못합니다 [/q2 OFF]
MSI_EXPLAIN_QUICKSPELL2	/quickspell2 : 마우스 WHEEL을 위,아래로 굴려서 F7과F8에 저장한 스킬을 사용합니다 On Off
MSI_EXPLAIN_QUICKSPELL3	/q3 : /quickspell (/q1) + /quickspell2 (/q2)
MSI_EMOTION_STARE	/찌릿
MSI_EMOTION_HUNGRY	/밥
MSI_EMOTION_COOL	/멋져
MSI_EMOTION_MERONG	/메롱
MSI_EMOTION_SHY	/부끄
MSI_EMOTION_GOODBOY	/쓱쓱
MSI_EMOTION_SPTIME	/엠탐
MSI_EMOTION_SEXY	/질질
MSI_EMOTION_COMEON	/컴온
MSI_EMOTION_SLEEPY	/하품
MSI_EMOTION_CONGRATULATION	/축하
MSI_EMOTION_HPTIME	/피탐
MSI_EXPLAIN_EMOTION	/이모션 : 현재 사용가능한 이모션의 리스트를 보여줍니다.
MSI_BATTLE_ON	키보드를 이용해서 스킬단축창 1,2,3의 스킬들을 사용합니다. [/bm ON]
MSI_BATTLE_OFF	키보드를 이용해서 스킬단축창 1,2,3의 스킬들을 사용하지못합니다. [/bm OFF]
MSI_EXPLAIN_BATTLE	/battlemode : Q ~ O 를 누르면 스킬단축창2의 스킬들이 사용됩니다.
MSI_EXPLAIN_BATTLE2	                    A ~ L 을 누르면 스킬단축창3의 스킬들이 사용됩니다.
MSI_EXPLAIN_LAG	라그나로크를 실행하실때 다른 프로그램을 띄우시면 게임이 느려질수도있습니다.
MSI_SUPERNOVICE1	천사님 제 목소리 들리세요? ^^;
MSI_SUPERNOVICE2	슈퍼노비스
MSI_SUPERNOVICE3	예요~
MSI_SUPERNOVICE4	저 좀 도와주세요~ ㅠ_ㅠ
MSI_SUGGEST_BABY	님께서 당신을 입양시키고 싶어하십니다. 승낙하시겠습니까?
MSI_EXPLAIN_BATTLE3	                    Z ~ > 을 누르면 스킬단축창1의 스킬들이 사용됩니다. On Off
MSI_EXPLAIN_BATTLE4	                    Space를 한번 누른뒤에 글자를 입력하면 채팅을 할수있습니다.
MSI_NPGAMEMON_ERROR_AUTH_GAMEGUARD	게임가드 파일이 없거나 변조되었습니다. 게임가드 셋업 파일을 설치해보시기 바랍니다.
MSI_NPGAMEMON_ERROR_CRYPTOAPI	윈도우의 일부 시스템 파일이 손상되었습니다. 인터넷 익스플로러(IE)를 다시 설치해보시기 바랍니다.
MSI_NPGAMEMON_ERROR_EXECUTE	게임가드 실행에 실패했습니다. 게임가드 셋업 파일을 다시 설치해보시기 바랍니다.
MSI_NPGAMEMON_ERROR_ILLEGAL_PRG	불법 프로그램이 발견되었습니다. 불필요한 프로그램을 종료한 후 다시 실행해보시기 바랍니다.
MSI_NPGMUP_ERROR_ABORT	게임가드 업데이트를 취소하셨습니다. 접속이 계속 되지 않을 경우 인터넷 및 방화벽 상태를 점검해보시기 바랍니다.
MSI_NPGMUP_ERROR_CONNECT	게임가드 업데이트 서버 접속에 실패하였습니다. 잠시 후 재시도 해보거나, 인터넷 및 방화벽 상태를 점검해 보시기 바랍니다.
MSI_NPGMUP_ERROR_AUTH	게임가드 업데이트를 완료하지 못 했습니다. 바이러스 검사를 해보시거나, PC 관리 프로그램을 사용하시면 설정을 조정한 후 게임을 실행해 보시기 바랍니다.
MSI_EXPLAIN_NOTRADE	/notrade : 거래신청을 자동으로 거절합니다 On Off
MSI_NOTRADE_ON	거래신청과 친구등록요청을 자동으로 거절합니다 [/nt ON]
MSI_NOTRADE_OFF	거래신청과 친구등록요청을 정상적으로 받습니다 [/nt OFF]
MSI_LIMIT_BUY_ITEM	같은 아이템은 한번에 30000개 이상은 살수 없습니다.
MSI_NOT_ENOUGH_SOURCE	재료가 충분하지 않습니다.
MSI_ALREADY_CONNECT	%s에 계정정보가 남아있습니다.
MSI_HACKING_INVESTIGATION	계정도용 조사를 위해 로그인이 금지되었습니다. 자세한 문의는 계정도용 관련 문의 메일로 해주시기 바랍니다.
MSI_BUG_INVESTIGATION	귀하는 버그관련 조사중이므로 일시적으로 접속을 금합니다
MSI_REPAIRITEMLIST	수리가능한 아이템
MSI_ITEM_REPAIR_SUCCEESS	아이템 수리 성공
MSI_ITEM_REPAIR_FAIL	아이템 수리 실패 (재료 또는 상대와의 거리등을 확인해주십시요)
MSI_SYSTEM_CHECK_ON	시스템 상황을 지속적으로 체크 합니다.[운영자모드] [/sc ON]
MSI_SYSTEM_CHECK_OFF	시스템 상황을 지속적으로 체크 하지 않습니다.[운영자모드] [/sc OFF]
MSI_EXPLAIN_SYSTEM_CHECK	/systemcheck : 시스템 상황을 지속적으로 체크 합니다.[운영자모드]
MSI_SUGGEST_JOIN_FRIEND	(%s)님이 친구 신청을 하셨습니다. 친구가 되시겠습니까?
MSI_FRIEND_ADD_ME_OVERSIZE	더 이상 친구 등록을 하실수 없습니다.
MSI_FRIEND_ADD_OTHER_OVERSIZE	(%s)님이 더 이상 친구 등록을 하실수 없습니다.
MSI_FRIEND_ADD_SUCCEED	(%s)님과 친구가 되셨습니다.
MSI_FRIEND_ADD_FALSE	(%s)님이 친구 되기를 원하지 않습니다.
MSI_BLOCKED	이 캐릭터는 %s 까지 블럭되어있습니다.
MSI_OVERPRICE	천만제니 이상 입력하셔도 가격은 천만제니로 판매됩니다.
MSI_LITTLEUSER	(적음)
MSI_ALITTLEUSER	(약간 적음)
MSI_NORMLEUSER	(보통)
MSI_MANYUSER	(많음)
MSI_VERYMANYUSER	(매우 많음)
MSI_GM_BAD_MANNER_START	비매너에 의해 운영자로부터 채팅금지가 적용됩니다.
MSI_GM_BAD_MANNER_REMAIN	GM에 의한 채팅금지가 %d 분 남아 있습니다.
MSI_GM_BAD_MANNER_END	GM에 의한 채팅금지가 해지 되었습니다.
MSI_AUTO_BAD_MANNER_START	도배 방지 시스템으로 인한 자동 채팅금지가 적용됩니다.
MSI_AUTO_BAD_MANNER_REMAIN	도배 방지 시스템으로 인한 채팅금지가 %d 분 남아 있습니다.
MSI_AUTO_BAD_MANNER_END	도배 방지 시스템으로 인한 채팅금지가 해지되었습니다. 게임진행 시에는 도배에 대해서 주의하여 주시기 바랍니다.
MSI_DIVORCE	%s님과 %s님이 이혼하셨습니다.
MSI_STARPLACE1	拳聖 %s의 태양의 장소로 %s 가 지정됐습니다.
MSI_STARPLACE2	拳聖 %s의 달의 장소로 %s 가 지정됐습니다.
MSI_STARPLACE3	拳聖 %s의 별의 장소로 %s 가 지정됐습니다.
MSI_STARPLACE4	拳聖 %s의 태양의 장소는 %s 입니다
MSI_STARPLACE5	拳聖 %s의 달의 장소는 %s 입니다
MSI_STARPLACE6	拳聖 %s의 별의 장소는 %s 입니다
MSI_STARMONSTER1	拳聖 %s의 태양의 몬스터로 %s 가 지정됐습니다.
MSI_STARMONSTER2	拳聖 %s의 달의 몬스터로 %s 가 지정됐습니다.
MSI_STARMONSTER3	拳聖 %s의 별의 몬스터로 %s 가 지정됐습니다.
MSI_STARMONSTER4	拳聖 %s의 태양의 몬스터는 %s 입니다
MSI_STARMONSTER5	拳聖 %s의 달의 몬스터는 %s 입니다
MSI_STARMONSTER6	拳聖 %s의 별의 몬스터는 %s 입니다
MSI_EXPLAIN_WINDOW	/window : 창 위치 이동시 다른 창과 달라붙는 속성이 들어갑니다 On Off
MSI_WINDOW_ON	창 위치 이동시 다른 창과 잘 붙습니다 [/wi ON]
MSI_WINDOW_OFF	창 위치 이동시 다른 창과 붙으려는 속성을 가지지 않습니다 [/wi OFF]
MSI_EXPLAIN_PVP_INFO	/pvpinfo : 자신의 PVP 승패와 PVP 포인트를 알 수 있습니다.
MSI_PVP_INFO	현재 %d승, %d패, PVP포인트는 %d입니다.
MSI_SEND_MANNER_POINT	매너 포인트를 성공적으로 보냈습니다.
MSI_PKZONE	현재 이곳은 PK 가능 지역입니다. 불의의 공격에 유의 하시기 바랍니다.
MSI_NPGAMEMON_ERROR_100ERROR	게임가드 업데이트가 바이러스나 스파이웨어와의 충돌로 실패했습니다. 백신 프로그램/스파이웨어 제거 프로그램을 사용한 후 접속해 주십시기 바랍니다
MSI_NPGAMEMON_XP_COMPATIBILITY	윈도우 호환성 문제로 프로그램을 종료합니다. 게임을 다시 실행해 주시기 바랍니다
MSI_PK_HONOR	채팅, 스킬, 아이템을 사용할수없게 되었습니다.
MSI_DELETING_CHAR	캐릭터 삭제 작업중이므로 접속이 일시적으로 제한됩니다.
MSI_DELETING_SPOUSE_CHAR	결혼 상대자의 캐릭터 삭제 작업중이므로 접속이 일시적으로 제한됩니다.
MSI_NOVICE	Novice
MSI_SWORDMAN	Swordman
MSI_MAGICIAN	Magician
MSI_ARCHER	Archer
MSI_ACOLYTE	Acolyte
MSI_MERCHANT	Merchant
MSI_THIEF	Thief
MSI_KNIGHT	Knight
MSI_PRIEST	Priest
MSI_WIZARD	Wizard
MSI_BLACKSMITH	Blacksmith
MSI_HUNTER	Hunter
MSI_ASSASSIN	Assassin
MSI_NOVICE_W	Novice
MSI_SWORDMAN_W	Swordman
MSI_MAGICIAN_W	Magician
MSI_ARCHER_W	Archer
MSI_ACOLYTE_W	Acolyte
MSI_MERCHANT_W	Merchant
MSI_THIEF_W	Thief
MSI_KNIGHT_W	Knight
MSI_PRIEST_W	Prieset
MSI_WIZARD_W	Wizerd
MSI_BLACKSMITH_W	Blacksmith
MSI_HUNTER_W	Hunter
MSI_ASSASSIN_W	Assassin
MSI_REQ_JOIN_BABY	(%s)님을 아이로 입양신청
MSI_SUGGEST_BABY2	아이가 되면 전승을 할수없고 스텟은 80이상 올릴수없게되며 HP와 SP가 줄어듭니다. 그래도 괜찮습니까?
MSI_GOSPEL1	모든 나쁜 상태이상이 제거 되었습니다.
MSI_GOSPEL2	1분간 모든 상태이상에 대해 면역이 됩니다.
MSI_GOSPEL3	1분간 최대 생명력이 크게 늘어납니다.
MSI_GOSPEL4	1분간 최대 마법력이 크게 늘어납니다.
MSI_GOSPEL5	1분간 모든 능력이 크게 상승합니다.
MSI_GOSPEL6	1분간 사용하는 무기에 성스러운 속성이 부여됩니다.
MSI_GOSPEL7	1분간 사용하는 갑옷에 성스러운 속성이 부여됩니다.
MSI_GOSPEL8	10초간 방어력이 크게 상승합니다.
MSI_GOSPEL9	1분간 공격력이 크게 증가합니다.
MSI_GOSPEL10	1분간 명중률과 회피율이 크게 상승합니다.
MSI_BABY1	아이를 한번 입양했던 부부는 추가 입양이 불가능합니다.
MSI_BABY2	부부가 둘다 레벨70이 넘어야 아이를 입양할수있습니다.
MSI_BLACKSMITH_POINT	[POINT] 블랙스미스 랭킹포인트가 %d 상승해서 %d 포인트가 되었습니다.
MSI_ALCHEMIST_POINT	[POINT] 알케미스트 랭킹포인트가 %d 상승해서 %d 포인트가 되었습니다.
MSI_SUPERNOVICE11	X
MSI_SUPERNOVICE12	X
MSI_SUPERNOVICE13	X
MSI_SUPERNOVICE14	X
MSI_EXPLAIN_NOTALKMSG2	/notalkmsg2 : 채팅내용을 채팅창에 표시하지 않습니다 (길드말 포함) On Off
MSI_NOTALKMSG2_ON	채팅내용을 채팅창에 표시합니다 [/nm2 ON]
MSI_NOTALKMSG2_OFF	채팅내용을 채팅창에 표시하지않습니다 (길드말 포함) [/nm2 OFF]
MSI_REFINEITEMLIST	제련가능한 아이템
MSI_ITEM_REFINE_SUCCEESS	제련한 무기 : %s
MSI_ITEM_REFINE_FAIL	제련한 무기 : %s
MSI_ITEM_REFINE_FAIL_LEVEL	무기제련스킬의 레벨이 부족해서 %s 제련을 할수없습니다.
MSI_ITEM_REFINE_FAIL_MATERIAL	제련에 필요한 아이템 (%s) 이 없으므로 제련할수없습니다.
MSI_FULLSTRIP	완벽하게 코팅되어있어서 풀스트립이 통하지 않습니다.
MSI_BABY3	결혼한 캐릭터는 입양시킬수 없습니다.
MSI_ID_WARNING	친구로 등록된 이름과 비슷하지만 등록된 이름이 아닙니다. 아는사람인지 확인하십시요.
MSI_EXPLAIN_HI	/hi 또는 /hi 문장 : 친구로 등록된 캐릭터들에게 인사를 합니다.
MSI_ID_WARNING_GUILD	길드원의 이름과 비슷하지만 길드원이 아닙니다. 길드원인지 확인하십시요.
MSI_OVERPRICE9999	9999만제니 이상 입력하셔도 가격은 9999만제니로 판매됩니다.
MSI_EXPLAIN_SACHING1	친구의 귓속말은 [ Friend ] , 길드원은 [ Member ] 로 표시됩니다.
MSI_EXPLAIN_SACHING2	( From 캐릭터이름 : ) 이라고 표시 되는 귓속말은 친구나 길드원이 아닙니다.
MSI_EXPLAIN_BLACKSMITH	/blacksmith : 블랙스미스의 상위 10위권 랭킹을 보여줍니다.
MSI_EXPLAIN_ALCHEMIST	/alchemist : 알케미스트의 상위 10위권 랭킹을 보여줍니다.
MSI_EXPLAIN_ALTY	ALT+Y : 여러가지 명령어를 쉽게 쓸수있는 윈도우가 열립니다.
MSI_TAEKWON_POINT	[POINT] 태권미션 랭킹포인트가 %d 상승해서 %d 포인트가 되었습니다.
MSI_TAEKWON_MISSION	[태권미션] Target Monster : %s (%d%%)
MSI_INIT_ERROR	게임가드 초기화 에러 : %lu
MSI_SPEEDHACK_DETECT	스피드핵이 감지되었습니다.
MSI_GAMEHACK_DETECT	불법 프로그램 (%s) 가 발견되었습니다
MSI_GAMEHACK_DOUBT	게임이나 게임가드가 변조되었습니다.
MSI_ERROR_EXIST	게임가드가 실행 중 입니다. 잠시 후에 다시 실행해보시기 바랍니다.
MSI_GAME_EXIST	게임이 중복 실행되었거나 게임가드가 이미 실행 중 입니다. 게임 종료 후 다시 실행해보시기 바랍니다.
MSI_ERROR_INIT	게임가드 초기화 에러입니다. 재부팅 후 다시 실행해보거나 충돌할 수 있는 다른 프로그램들을 종료한 후 실행해 보시기 바랍니다.
MSI_ERROR_NPSCAN	바이러스 및 해킹툴 검사 모듈 로딩에 실패 했습니다. 메모리 부족이거나 바이러스에 의한 감염일 수 있습니다.
MSI_HOMUN_INFO	호문클루스 정보
MSI_HOMUN_SKILLLIST	호문클루스 스킬목록
MSI_HOMUN_NAME_IN23	호문클루스의 이름은 영문 23, 한글 11자 이내로 정해 주세요.
MSI_HOMUN_NAME_CHANGE_ONLYONCE	이름은 단 한번만 바꿀수 있습니다. 호문클루스의 이름을 ^0000ff^0000ff %s^000000^000000 로 수정합니다. 계속 하시겠습니까?
MSI_AUTO_MSG	지금은 부재중~
MSI_AUTO_MSG2	[자동응답] 
MSI_AUTO_MSG_ON	부재시 타인의 귓말에 자동응답합니다.
MSI_AUTO_MSG_OFF	부재시 타인의 귓말에 자동응답하지 않습니다.
MSI_ENTER_AUTO_MSG	자동 응답 메시지를 입력하세요.
MSI_EMOTION_SPARK	/번쩍
MSI_EMOTION_CONFUSE	/빙빙
MSI_EMOTION_OHNO	/하아
MSI_EMOTION_HUM	/덤덤
MSI_EMOTION_BLABLA	/시끌
MSI_EMOTION_OTL	/좌절
MSI_EMOTION_DICE	/주사위
MSI_EXPLAIN_KILLER_RANK	/pk : 학살자의 상위 10위권 랭킹을 보여줍니다.
MSI_KILLER_POINT	[POINT] 학살자 랭킹포인트가 %d 상승해서 %d 포인트가 되었습니다.
MSI_HOMUN_EVOLVE	진화 가능
MSI_DELETE_HOMUN	^ff0000^ff0000호문클루스를 삭제합니다.^000000^000000 삭제하실 경우 지금까지 키운 내역이 모두 삭제됩니다. 계속하시겠습니까?
MSI_TRACE_AI_ON	호문의 상태를 파일에 저장합니다.
MSI_TRACE_AI_OFF	호문의 상태를 파일에 저장하지 않습니다.
MSI_CRUSADER	Crusader
MSI_MONK	Monk
MSI_SAGE	Sage
MSI_ROGUE	Rouge
MSI_ALCHEMIST	Alchemist
MSI_BARD	Bard
MSI_CRUSADER_W	Crusader_W
MSI_MONK_W	Monk_W
MSI_SAGE_W	Sage_W
MSI_ROGUE_W	Rouge_W
MSI_ALCHEMIST_W	Alchemist_W
MSI_DANCER	Dancer
MSI_NOVICE_H	Novice High
MSI_SWORDMAN_H	Swordman High
MSI_MAGICIAN_H	Magician High
MSI_ARCHER_H	Archer High
MSI_ACOLYTE_H	Acolyte High
MSI_MERCHANT_H	Merchant High
MSI_THIEF_H	Thief High
MSI_NOVICE_H_W	Novice High_W
MSI_SWORDMAN_H_W	Swordman High_W
MSI_MAGICIAN_H_W	Magician High_W
MSI_ARCHER_H_W	Archer High_W
MSI_ACOLYTE_H_W	Acolyte High_W
MSI_MERCHANT_H_W	Merchant High_W
MSI_THIEF_H_W	Thief High_W
MSI_KNIGHT_H	Lord Knight
MSI_PRIEST_H	High Priest
MSI_WIZARD_H	High Wizard
MSI_BLACKSMITH_H	White Smith
MSI_HUNTER_H	Sniper
MSI_ASSASSIN_H	Assassin Cross
MSI_KNIGHT_H_W	Lord Knight_W
MSI_PRIEST_H_W	High Priest_W
MSI_WIZARD_H_W	High Wizard_W
MSI_BLACKSMITH_H_W	White Smith_W
MSI_HUNTER_H_W	Sniper_W
MSI_ASSASSIN_H_W	Assassin Cross_W
MSI_CRUSADER_H	Paladin
MSI_MONK_H	Champion
MSI_SAGE_H	Professor
MSI_ROGUE_H	Stalker
MSI_ALCHEMIST_H	Creator
MSI_BARD_H	Clown
MSI_CRUSADER_H_W	Paladin_W
MSI_MONK_H_W	Champion_W
MSI_SAGE_H_W	Professor_W
MSI_ROGUE_H_W	Stalker_W
MSI_ALCHEMIST_H_W	Creator_W
MSI_DANCER_H	Gypsy
MSI_STORE_PASSWORD_REQ	비밀번호가 지정되어 있지 않습니다. 새로운 비밀번호를 지정하시겠습니까?
MSI_STORE_PASSWORD_PENALTY	비밀번호를 3회 틀려셨습니다. 나중에 다시 시도해 주세요.
MSI_STORE_PASSWORD_CHANGE_NG	비밀번호 변경이 실패하였습니다.
MSI_STORE_PASSWORD_4_8	비밀번호는 4자리 이상 8자리이하여야만 합니다.
MSI_STORE_PASSWORD	비밀번호
MSI_STORE_NEW_PASSWORD	신규 비밀번호
MSI_STORE_RENEW_PASSWORD	확인 비밀번호
MSI_STORE_PASSWORD_CHANGE_OK	비밀번호 변경이 완료되었습니다.
MSI_STORE_PASSWORD_MISMATCH	비밀번호가 서로 다릅니다.
MSI_STORE_PASSWORD_INPUT	비밀번호 입력
MSI_HOMUN_HUNGRY	호문이 아사 직전입니다! 먹이를 주지 않으면 가출하게됩니다.
MSI_HOMUN_EXP	경험치
MSI_EVENT_RESULT	수령하지 않은 아이템이 존재합니다. 알베르타의 존다 기획사 직원을 찾아주세요. ^ff0000※ 아이템 수령 기간이 지나면 아이템이 소실 됩니다!^000000
MSI_HATE	싫어함
MSI_VERYHATE	매우싫어함
MSI_HOMUN_USERAI_ON	호문클루스가 사용자 인공지능으로 동작합니다.
MSI_HOMUN_USERAI_OFF	호문클루스가 기본 인공지능으로 동작합니다.
MSI_MAIL_LIST	편지목록
MSI_MAIL_WRITE	편지쓰기
MSI_MAIL_READ	편지읽기
MSI_STARPLACE_ACCEPT	한번 지정하시면 변경이 불가능합니다!     이 맵으로 지정하시겠습니까?
MSI_MAIL_ADD_ITEM_SUCCESS	메일 아이템을 수령했습니다.
MSI_MAIL_ADD_ITEM_FAILURE	메일 아이템을 수령하지 못했습니다.
MSI_MAIL_SEND_SUCCESS	메일 보내기가 성공하였습니다.
MSI_MAIL_USER_NOT_FOUND	메일 보내기가 실패하였습니다. 받는 사람이 존재하지 않습니다.
MSI_STAR_ANGEL	[태양과 달과 별의 천사] 지정했던 장소들과 몬스터들이 초기화됐습니다!
MSI_AUCTION_ADD_FALSE	경매 등록이 실패했습니다.
MSI_AUCTION_ADD_TRUE	경매 등록이 성공했습니다.
MSI_AUCTION_ADD_CANCEL	해당 경매가 취소되었습니다.
MSI_AUCTION_ADD_CANCEL_FALSE	입찰자가 있는 경매는 취소할 수 없습니다.
MSI_MAIL_DELETE_SUCCESS	메일 삭제가 성공하였습니다.
MSI_MAIL_DELETE_FAILURE	메일 삭제가 실패하였습니다.
MSI_MSG_KNIFE_EQUIPMENT_SUCCESS	던지는 단검이 장착되었습니다.
MSI_LOGIN_FRIEND	%s 님이 로그인했습니다.
MSI_LOGOUT_FRIEND	%s 님이 로그아웃했습니다.
MSI_EXPLAIN_LOGINOUT	/loginout 또는 /li : 길드원과 친구들의 접속관련 메세지를 보여줍니다. On Off
MSI_LOGINOUT_ON	친구들의 접속관련 메세지를 대화창에 표시합니다. [/li ON]
MSI_LOGINOUT_OFF	친구들의 접속관련 메세지를 대화창에 표시하지않습니다.  [/li OFF]
MSI_SGP_CODE_ALREADY_RUNNING	이미 실행중입니다.
MSI_SGP_CODE_DETECTED_MACRO	매크로 사용이 감지되었습니다.
MSI_SGP_CODE_DETECTED_SPEEDHACK	스피드해킹이 감지되었습니다.
MSI_SGP_CODE_DETECTED_APIHOOK	API 후킹이 감지되었습니다.
MSI_SGP_CODE_DETECTED_MSGHOOK	메시지 후킹이 감지되었습니다.
MSI_SGP_CODE_NOT_EQUALENCRYPTEDDATA	모듈이 변조 또는 손상되었거나 버전이 일치하지 않습니다.
MSI_BILLING_PCB	(태국)귀하는 게임방 과금으로 로그인 하셨습니다.
MSI_PREV_PAGE	이전
MSI_NEXT_PAGE	다음
MSI_AUCTION	경매
MSI_AUCTION_VIEW	물품보기
MSI_AUCTION_ADD	등록하기
MSI_AUCTION_SELL	판매 진행상태
MSI_AUCTION_BUY	구매 진행상태
MSI_ITEM2	아이템
MSI_ITEM_NAME2	아이템명
MSI_ITEM_PRICE	가격 / 즉시구입가격
MSI_SELLER	판매자
MSI_BUYER	구매자
MSI_FINISH_TIME	종료시간
MSI_TIME_TYPE	%m월 %d일 %H시
MSI_SET_TIME	시간설정
MSI_CHARGE	수수료
MSI_NOTHING_SEARCH_ITEM	검색된 아이템이 없습니다.
MSI_NOTHING_SEARCH_SELL_ITEM	현재 판매중인 아이템이 없습니다.
MSI_NOTHING_SEARCH_BUY_ITEM	현재 구매중인 아이템이 없습니다.
MSI_ERROR_AUCTION_ITEM_INFO	경매정보가 정확하지 않습니다.
MSI_NOTHING_AUCTION_ITEM_INFO	경매에 등록할 아이템 정보가 없습니다.
MSI_ERROR_ADD_AUCTION	이미 등록된 경매입니다.
MSI_PRICE	제시가격
MSI_PRICE2	구입희망가격
MSI_PRICE3	즉시구입가격
MSI_PRICE4	현재소지제니
MSI_PRICE5	현재최고가격
MSI_PRICE6	이전입찰가격
MSI_PRICE7	추가입찰가격
MSI_BUY_ACTION_ITEM	구입하시겠습니까?
MSI_SELL_ACTION_ITEM	이 가격에 판매하시겠습니까?
MSI_BUY_AUCTION	입찰하기
MSI_BUY_AUCTION2	즉시구매하기
MSI_BUY_AUCTION3	경매종료하기
MSI_FINISH_AUCTION	재입찰하기
MSI_RESULT_BUY_TRUE	해당 경매에 대한 입찰이 성공했습니다.
MSI_RESULT_BUY_FALSE	해당 경매에 대한 입찰이 실패했습니다.
MSI_RESULT_BUY_FALSE_MONEY	제니가 충분하지 않습니다.
MSI_EQUIP	방어구
MSI_CARD	카드
MSI_ETC	기타
MSI_AUCTION_NUM	경매번호
MSI_AUCTION_SEARCH	검색
MSI_RESULT_MY_SELL_STOP_TRUE	해당 경매를 종료했습니다.
MSI_RESULT_MY_SELL_STOP_FALSE	해당 경매를 종료 할 수 없습니다.
MSI_RESULT_AUCTION_ID_FALSE	경매 번호가 정확하지 않습니다.
MSI_SENDER	받는이
MSI_TITLE2	제 목
MSI_NEW_MAIL	새 메일이 도착하였습니다.
MSI_SEARCHING_ITEM	검색중입니다.
MSI_AUCTION_ADD_OVER	더 이상 경매 등록할 수 없습니다. 경매 등록은 최대 5개까지 가능합니다.
MSI_RESULT_BUY_OVER	더 이상 경매 물품에 입찰할 수 없습니다. 경매 물품 입찰은 최대 5개까지 가능합니다.
MSI_MAIL_DELETE_ERROR	삭제하려는 메일에 수령하지 않은 아이템이 있습니다.
MSI_MAIL_SEND_ERROR	메일 제목을 입력하여 주십시오.
MSI_EXPLAIN_SHOPPING	/shopping : 클릭 한번으로 상점을 열고 상점이름 오른쪽 클릭으로 상점을 닫습니다 On Off
MSI_SHOPPING_ON	클릭 한번으로 상점을 열고 상점이름을 오른쪽 클릭해서 상점을 닫을수있습니다. [/sh ON]
MSI_SHOPPING_OFF	더블클릭 으로 상점을 열게됩니다.  [/sh OFF]
MSI_MAIL_SEND_ERROR2	메일을 보내려면, 제니 입력을 완료해야 합니다.
MSI_ADD_MONEY_FALSE	경매 수수료가 부족합니다.
MSI_HOMUN_SHOWINFO	상태보기
MSI_HOMUN_FEEDING	먹이주기
MSI_HOMUN_WAITING	대기
MSI_JOB_SUPERNOVICE_M	슈퍼노비스(남)
MSI_JOB_SUPERNOVICE_F	슈퍼노비스(여)
MSI_JOB_TAEKWON_M	태권소년
MSI_JOB_TAEKWON_F	태권소녀
MSI_KWONSUNG_M	권성(남)
MSI_KWONSUNG_F	권성(여)
MSI_SOULLINGKER_M	소울링커(남)
MSI_SOULLINGKER_F	소울링커(여)
MSI_BAN_PC_IP_UNFAIR	PC방요금제로 2개이상의 계정이 접속되고있습니다. 확인후 다시 사용하시기 바랍니다.
MSI_BILLING_1	귀하는 월정액 요금제 사용자 입니다. (남은기간 : %d일)
MSI_BILLING_2	귀하는 정량 요금제 사용자 입니다. (남은시간 : %d시간 %분 %초)
MSI_MAIL_ITEM_ADD_FAILED	해당 아이템은 메일에 첨부 할수 없는 아이템입니다.
MSI_MAIL_ADD_ITEM_OVER_FAILURE	더이상 아이템을 가질수 없습니다. 아이템은 메일로 보관하겠습니다.
MSI_PTSEX1	남성
MSI_PTSEX2	여성
MSI_PT_NEWUSER	새로운 유저입니다
MSI_PT_ACINFO	E-mail은 캐릭터를 지울때 필요합니다.
MSI_PT_ACINFO2	정확한 형식으로 입력해 주세요.
MSI_PT_NEWKEYINFO	이 키를 사용하세요
MSI_PT_FAIL_CARDPASS	정확한 카드 패스워드를 다시 입력해주세요
MSI_PTID1	PT정보
MSI_PTID2	PT_ID는 %s
MSI_PTID3	NUM_ID는 %s
MSI_PTID4	잊지않게 주의하세요
MSI_PT_ERROR_1001	1001
MSI_PT_ERROR_1002	1002
MSI_PT_ERROR_1003	1003
MSI_PT_ERROR_1004	1004
MSI_PT_ERROR_1006	1006
MSI_PT_ERROR_1007	1007
MSI_PT_ERROR_1008	1008
MSI_PT_ERROR_1009	1009
MSI_PT_ERROR_1012	1012
MSI_PT_ERROR_1013	1013
MSI_PT_ERROR_1014	1014
MSI_PT_ERROR_1015	1015
MSI_PT_ERROR_1019	1019
MSI_PT_ERROR_1020	1020
MSI_PT_ERROR_1021	1021
MSI_PT_ERROR_1023	1023
MSI_PT_ERROR_1024	1024
MSI_PT_ERROR_1025	1025
MSI_PT_ERROR_1027	1027
MSI_PT_ERROR_1028	1028
MSI_PT_ERROR_10	10
MSI_PT_ERROR_20	20
MSI_PT_ERROR_40	40
MSI_PT_ERROR_50	50
MSI_PT_ERROR_60	60
MSI_PT_ERROR_70	70
MSI_PT_ERROR_80	80
MSI_PT_ERROR_90	90
MSI_PT_ERROR_100	100
MSI_PT_ERROR_110	110
MSI_PT_POINT1	30포인트를 받으시겠습니까?
MSI_PT_POINT2	30포인트(5시간)이 충전되었습니다
MSI_AUCTION_ADD_ITEM_FAILURE	감정되지 않은 아이템은 경매에 등록할 수 없습니다.
MSI_AUCTION_ADD_ITEM_FAILURE2	소비 아이템은 경매에 등록할 수 없습니다.
MSI_CLOSE_MERCHANTITEMWND	메일창을 열려면 카트창을 닫아 주십시요.
MSI_CLOSE_MAILWND	카트창을 열려면 메일창을 닫아 주십시요.
MSI_MSG_BULLET_EQUIPMENT_SUCCESS	탄환이 장착되었습니다.
MSI_MAIL_RETURN_SUCCESS	메일이 반송되었습니다.
MSI_MAIL_RETURN_FAILURE	메일이 존재하지 않습니다.
MSI_BAN_PC_IP_COUNT_ALL	한시간 동안, 동일한 IP로 접속한 유저가 30건 이상입니다. 확인후 다시 사용하시기 바랍니다.
MSI_BAN_PC_IP_COUNT	한시간 동안, 동일한 IP로 10번 이상 접속되었습니다. 확인후 다시 사용하시기 바랍니다.
MSI_GAMEGUARD_RESTART	게임을 재시작 하십시오 
MSI_MER_INFO_TYPE_ARCHER	용병정보 - 아쳐타입
MSI_MER_INFO_TYPE_SWORDMAN	용병정보 - 검사타입
MSI_MER_INFO_TYPE_LANCER	용병정보 - 창병타입
MSI_LEFT_TIME	삭제시간
MSI_MER_FRIENDLY	신뢰도
MSI_MER_CALLCOUNT	소환횟수
MSI_MER_KILL	Kill
MSI_PET_STARVING	펫이 배가 고파서 당신을 원망하고 있다는 느낌이 든다.
MSI_GANGSI_POINT	[POINT] 테이밍미션 랭킹포인트가 %d 상승해서 %d 포인트가 되었습니다.
MSI_GANGSI_MISSION	[테이밍미션] Target Monster : %s
MSI_EXPLAIN_HUNTING	/hunting : 사냥 목록을 보여줍니다.
MSI_DEATH_Q01	[천사의질문] 소녀에게 가르쳐주시어요. %s는 몇 스킬 찍으셨나요?
MSI_DEATH_Q02	[천사의질문] 소녀에게 가르쳐주시어요. 소지하시고있는 제니를 십만으로 나누면 얼마가 되시나요?
MSI_DEATH_Q03	[천사의질문] 소녀에게 가르쳐주시어요. 오늘이 몇일이신지 아시나요?
MSI_DEATH_Q04	[천사의질문] 소녀에게 가르쳐주시어요. %s은 지금 몇이신가요?
MSI_DEATH_Q05	[천사의질문] A는 1이고 Z는 26이어요. 슈노, 태권계열, 무낙계열을 담당하고있는 SiYeon씨의 알파벳을 더하면 몇이 되나요?
MSI_DEATH_Q06	[천사의질문] A는 1이고 Z는 26이어요. 귀엽고 어여쁜 라그나로크의 히로인 Munak의 알파벳을 더하면 몇이 되나요?
MSI_DEATH_Q07	[천사의질문] A는 1이고 Z는 26이어요. 제가 어여뻐하는 Bongun의 알파벳을 더하면 몇이 되나요?
MSI_DEATH_Q08	[천사의질문] A는 1이고 Z는 26이어요. 저희가 존재하는 온라인세계 Ragnarok의 알파벳을 더하면 몇이 되나요?
MSI_DEATH_Q09	[천사의질문] A는 1이고 Z는 26이어요. 언제나 Online상태인 천사동료들은 큰힘이 되어주죠. Online의 알파벳을 더하면 몇이 되나요?
MSI_DEATH_Q10	[천사의질문] A는 1이고 Z는 26이어요. 죽음도 두려워하지않는 기사들을 상징하는 단어인 Death의 알파벳을 더하면 몇이 되나요?
MSI_DEATH_Q11	[천사의질문] A는 1이고 Z는 26이어요. 기사들은 너무 멋진다고 생각해요. Knight의 알파벳을 더하면 몇이 되나요?
MSI_DEATH_Q12	[천사의질문] A는 1이고 Z는 26이어요. 중력을 뜻하는 단어인 Gravity의 알파벳을 더하면 몇이 되나요?
MSI_DEATH_Q13	[천사의질문] A는 1이고 Z는 26이어요. 어둠속에서도 밝게 사는게 중요하지요. Dark의 알파벳을 더하면 몇이 되나요?
MSI_DEATH_Q14	[천사의질문] A는 1이고 Z는 26이어요. 뭐든지 수집하는 Collector의 알파벳을 더하면 몇이 되나요?
MSI_DEATH_R01	[천사의대답] 소녀에게 정확한 사실을 가르쳐주셔서 감사하옵니다.
MSI_DEATH_R02	[천사의대답] 사랑스러우신 분이시군요. 소녀 감탄했사옵니다.
MSI_DEATH_R05	[천사의대답] 소녀 실망했사옵니다.
MSI_DEATH_POINT	[POINT] 랭킹포인트가 %d 상승해서 %d 포인트가 되었습니다.
MSI_POINT_SHOP	[%s]의 소지 캐시 : %d 캐시
MSI_CONFIRM_SELECT_CHARACTERS	선택하지 않은 캐릭터는 삭제 됩니다. 완료하시겠습니까?
MSI_ERROR_SELECT_CHARACTERS	9개 이상 선택하실 수 없습니다.
MSI_CONFIRM_TO_CHANGE_NAME	캐릭터명을 '%s' (으)로 변경하시겠습니까?
MSI_CHANGE_NAME_SUCCESS	캐릭터명이 성공적으로 변경되었습니다.
MSI_CHANGE_NAME_FAILURE	캐릭터명 변경이 실패하였습니다.
MSI_CAN_BUY_ONLY_ONEITEM	한 번에 한 종류의 아이템만 구매할 수 있습니다.
MSI_NO_SELECT_CHARACTERS	캐릭터가 한개도 선택되지 않았습니다.  반드시 한개 이상의 캐릭터를 선택하여야 합니다.
MSI_ALREADY_CHANGED_NAME	이미 캐릭터명을 변경한 적이 있습니다. 더 이상 변경 할 수 없습니다.
MSI_NOTREGISTED_USER	사용자 정보가 정확하지 않습니다.
MSI_DUPLICATED_CHAR_NAME	다른 사용자가 같은 캐릭터 명을 먼저 사용하였습니다. 다른 캐릭터명을 사용하여 주십시요.
MSI_CANNOT_PARTYCALL	파티장 권한이 없어 파티원을 소환하지 못했습니다.
MSI_NO_PARTYMEM_ON_THISMAP	현재 맵에는 소환될 파티원이 존재하지 않습니다.
MSI_NOTFIND_BOSSMON	이 지역에선 보스몬스터의 흔적을 찾을 수가 없습니다.
MSI_APPEARANCE_TIME_OF_BOSSMON	보스 몬스터 '%s'(이)가  %d시간 %d분 후에 등장합니다.
MSI_SHOW_POSITION_OF_BOSSMON	보스 몬스터 '%s'의 위치가 미니맵에 표시됩니다.
MSI_CONFIRM_TO_OPEN_CASH_ITEM	'%s'를 개봉 하시겠습니까?  ^ff0000상자를 개봉하시면 청약 철회 대상에서 제외 됩니다.^000000 한번 개봉 된 아이템은 창고 저장 외의 다른 이동은 불가하며 임대 아이템은 창고 저장도 불가합니다. 한정 아이템은 거래 및 이동이 가능 합니다. 동일한 아이템을 중복 사용하더라도 효과가 중첩되지 않습니다.
MSI_BUY_CASH_FAIL_NPC	NPC가 존재하지 않아 구매가 실패하였습니다.
MSI_BUY_CASH_FAIL_SYSTEM	부분 유료화 시스템이 정상 작동하지 않아 구매가 실패하였습니다.
MSI_BUY_CASH_FAIL_EXCHANGE	교환중에는 아이템을 구매 할 수 없습니다.
MSI_BUY_CASH_FAIL_ITEM_ID	아이템 정보가 정확하지 않아 구매가 실패하였습니다.
MSI_ENST_STR	 STR이 향상되었습니다.
MSI_DSST_STR	 STR이 원래대로 돌아왔습니다.
MSI_ENST_AGI	 AGI이 향상되었습니다.
MSI_DSST_AGI	 AGI이 원래대로 돌아왔습니다.
MSI_ENST_VIT	 VIT이 향상되었습니다.
MSI_DSST_VIT	 VIT이 원래대로 돌아왔습니다.
MSI_ENST_INT	 INT이 향상되었습니다.
MSI_DSST_INT	 INT이 원래대로 돌아왔습니다.
MSI_ENST_DEX	 DEX이 향상되었습니다.
MSI_DSST_DEX	 DEX이 원래대로 돌아왔습니다.
MSI_ENST_LUK	 LUK이 향상되었습니다.
MSI_DSST_LUK	 LUK이 원래대로 돌아왔습니다.
MSI_ENST_AVOIDANCE	 회피율이 향상되었습니다.
MSI_DSST_AVOIDANCE	 회피율이 원래대로 돌아왔습니다.
MSI_ENST_HIT	 명중률이 향상되었습니다.
MSI_DSST_HIT	 명중률이 원래대로 돌아왔습니다.
MSI_ENST_CRITICALSUCCESSVALUE	 크리티컬 확률이 향상되었습니다.
MSI_DSST_CRITICALSUCCESSVALUE	 크리티컬 확률이 원래대로 돌아왔습니다.
MSI_PLUSEXP	 30분간 얻을 수 있는 경험치가 50%% 증가합니다.
MSI_DDEATHPENALTY	 30분내 사망시 1회에 한해 경험치 감소가 일어나지 않습니다.
MSI_RECEIVEITEM	 몬스터 사냥을 통해 얻을 수 있는 기본 아이템의 드롭률이 30분간 2배로 증가합니다.
MSI_BOSS_ALARM	 10분간 맵 내에 출현 가능한 보스 몬스터에 대한 정보를 안내해 드립니다.
MSI_BUY_RECONFIRM	 ^ff0000본 아이템을 구매 후 7일 이내에는 청약 철회가 가능합니다. 다만, 7일이 지났거나 아이템을 개봉하시면 청약 철회 대상에서 제외 됩니다.또한 구매시 사용된 무료캐시는 청약철회시 반환되지 않습니다.^000000 정말로 아이템을 구매하시겠습니까? 구매하실 경우 %d캐시가 차감됩니다.
MSI_BUY_CASH_FAIL_MONEY	 캐시가 부족합니다.
MSI_NOTICE_TO_DELETE_TIME	 ^ff0000파기일시: %s^000000
MSI_NOTICE_TO_REMAIN_ITEMUSINGTIME	 '%s'아이템의 사용시간이 %d분 남았습니다.
MSI_LAST_NOTICE_TO_REMAIN_ITEMUSINGTIME	 1분 후, '%s'아이템이 인벤토리에서 삭제됩니다.
MSI_NOTICE_TO_DELETE_ITEM	 '%s'아이템이 인벤토리에서 삭제되었습니다.
MSI_INPUT_NUMBER	Input Number
MSI_TIME_TYPE2	%m월 %d일 %H시 %M분
MSI_APPEARANCE_TIME_OF_BOSSMON2	보스 몬스터 '%s'(이)가 잠시 후에 등장합니다.
MSI_MER_SKILLLIST	용병 스킬목록
MSI_DA_EXP_ACCEPT	블랙젬스톤 1개와 백만제니를 소모하는 마법의 실행에 동의합니까?
MSI_COLLECTOR_POINT	[POINT] 콜렉터랭킹 포인트가 %d 상승해서 %d 포인트가 되었습니다.
MSI_COLLECTOR_MISSION	[콜렉터랭킹] Target Item : %s
MSI_MER_FINISH	용병 사용시간이 만료되었습니다.
MSI_MER_DIE	용병이 사망하였습니다.
MSI_MER_RETIRE	용병이 해고되었습니다.
MSI_MER_RUNAWAY	용병이 도망갔습니다.
MSI_NOTICE_TO_REMAIN_ITEMUSINGTIME2	 '%s'아이템의 사용시간이 %d초 남았습니다.
MSI_PCBANG_EVENT	PC방 프리미엄 서비스 : 경험치 %d%% 증가, 사망 페널티 %d%% 감소, 드롭율 %d%% 증가
MSI_LIMIT_CHAR_DELETE	24시간 이후에 시도하세요
MSI_MER_USERAI_ON	용병이 사용자 인공지능으로 동작합니다.
MSI_MER_USERAI_OFF	용병이 기본 인공지능으로 동작합니다.
MSI_CHARACTER_NAME	 %s님의
MSI_ITEM_PICKUP_PARTY	%s님이 %s 아이템을 획득하셨습니다.
MSI_VIEW_CHAT_MSG	공개 채팅 메시지 표시
MSI_VIEW_WHISPER_MSG	귓속말 채팅 메시지 표시
MSI_VIEW_PARTY_MSG	파티 채팅 메시지 표시
MSI_VIEW_GUILD_MSG	길드 채팅 메시지 표시
MSI_VIEW_GET_ITEM_MSG	아이템 획득/드롭 메시지 표시
MSI_VIEW_EQUIP_MSG	장비 장착/해제 메시지 표시
MSI_VIEW_CHANGE_STATUS_MSG	상태이상 메시지 표시
MSI_VIEW_GET_ITEM_PARTY_MSG	파티원의 주요 아이템 획득 메시지 표시
MSI_VIEW_CHANGE_STATUS_PARTY_MSG	파티원의 상태이상 메시지 표시
MSI_VIEW_FAIL_SKILL_MSG	스킬 사용 실패 메시지 표시
MSI_VIEW_PARTY_SETUP_MSG	파티 설정 메시지 표시
MSI_VIEW_DAMAGED_EQUIP_MSG	장비 손상 메시지 표시
MSI_BATTLE_CHAT_WND_OPTION	배틀 메시지 창 표시 정보
MSI_POINT_SHOP_NHN	[%s]의 소지 한코인 : %d 한코인
MSI_ST_CHAT	일반 메시지
MSI_BT_CHAT	배틀 메시지
MSI_PHONE_CONFIRM	휴대폰 인증.
MSI_BOOK_READ	읽기
MSI_BOOK_AUTOREAD	자동낭독
MSI_BOOK_KEEP	책갈피
MSI_BOOK_PREV	이전페이지
MSI_BOOK_NEXT	다음페이지
MSI_BOOK_CLOSE	닫기
MSI_DAMAGED_EQUIP	%s 장비가 손상되었습니다.
MSI_DAMAGED_EQUIP_PARTY	%s님의 %s 손상되었습니다.
MSI_DAMAGED_WEAPON	무기가
MSI_DAMAGED_BODY	갑옷이
MSI_NOT_ENOUGH_SKILLLEVE5_2	스킬레벨이 부족합니다. 파티가입 불능
MSI_POINT_SHOP2	[%s]의 무료 캐시 : %d 캐시
MSI_USE_FREE_POINT	무료 캐시 사용 : 
MSI_CASH	캐시
MSI_SETTLE_WEB_URL_HANGAME	http://payment.ro.hangame.com/index.asp
MSI_BAN_GRAVITY_MEM_AGREE	그라비티 회원 정보동의를 하셔야 사용할 수 있습니다.
MSI_BAN_GAME_MEM_AGREE	이용약관에 동의를 하셔야 본 서비스를 이용하실 수 있습니다.
MSI_BAN_HAN_VALID	입력하신 아이디와 비밀번호가 등록된 정보와 일치하지 않습니다.
MSI_BUY_RECONFIRM2	 ^ff0000본 아이템을 구매 후 7일 이내에는 청약 철회가 가능합니다. 다만, 7일이 지났거나 아이템을 개봉하시면 청약 철회 대상에서 제외 됩니다.또한 구매시 사용된 무료캐시는 청약철회시 반환되지 않습니다.^000000 정말로 아이템을 구매하시겠습니까? 구매하실 경우 일반 %d캐시, 무료 %d캐시가 차감됩니다.
MSI_NOTIFY_PLAYTIME1	%d시간이 경과하였습니다.
MSI_NOTIFY_PLAYTIME2	%d시간 %d분이 경과하였습니다.
MSI_WARNING_MSG1	게임을 종료하세요, 경험치 및 모든게 50%로 조정됩니다
MSI_WARNING_MSG2	불건전 시간대에 접어들었습니다. 게임을 종료하세요, 경험치 및 모든게 0%로 조정됩니다
MSI_QUESTWIN	퀘스트 목록
MSI_RO_SHOP	RO SHOP
MSI_MDUNGEON_SUBSCRIPTION_ERROR_UNKNOWN	메모리얼던젼 '%s'의 예약이 알수없는 이유로 실패 하였습니다.
MSI_MDUNGEON_SUBSCRIPTION_ERROR_DUPLICATE	메모리얼던젼 '%s'의 예약이 예약중복으로 실패 하였습니다.
MSI_MDUNGEON_SUBSCRIPTION_ERROR_RIGHT	메모리얼던젼 '%s'의 예약이 권한문제로 실패 하였습니다.
MSI_MDUNGEON_SUBSCRIPTION_ERROR_EXIST	메모리얼던젼 '%s'의 예약이 중복생성요청으로 실패하였습니다.
MSI_MDUNGEON_SUBSCRIPTION_CANCEL_FAIL	메모리얼던젼 '%s'의 예약취소가 실패 하였습니다.
MSI_JOINMSG_REFUSE	상대방이 파티 초대 거부 상태입니다.
MSI_INVITE_PARTY_REFUSE	모든 파티 초대를 거부합니다.
MSI_INVITE_PARTY_ACCEPT	모든 파티 초대를 수락합니다.
MSI_YOURITEM_EQUIP	착용하시면 이 아이템은 영구 귀속됩니다. 착용하시겠습니까?
MSI_YOURITEM_EQUIPED	%s 아이템이 귀속되었습니다.
MSI_BUY_TO_FREE_POINT	캐시가 부족합니다. 무료 캐시 포인트를 입력해 주시기 바랍니다.
MSI_REQ_JOIN_PARTY3	파티 가입요청
MSI_VIEW_SIEGE_INFO_MSG	공성 정보 메시지 표시
MSI_MDUNGEON_SUBSCRIPTION_CANCEL_SUCCESS	메모리얼던젼 '%s'의 예약이 취소 되었습니다.
MSI_MDUNGEON_CREATE_FAIL	메모리얼던젼 '%s' 생성에 실패하였습니다. 다시 시도 하세요.
MSI_IMPOSSIBLE_SKILL_AREA	이 장소에서는 사용할 수 없는 스킬입니다.
MSI_IMPOSSIBLE_USEITEM_AREA	이 장소에서는 사용할 수 없는 아이템입니다.
MSI_MEMORIAL_DUN	메모리얼 던전
MSI_MEMORIAL_DUN_WAITING	%s 대기중
MSI_MEMORIAL_DUN_READY	%s 입장 가능
MSI_MEMORIAL_DUN_IN	%s 진행중
MSI_MEMORIAL_DUN_OUT1	시간 안에 입장하지 않아 메모리얼 던전이 사라졌습니다.
MSI_MEMORIAL_DUN_OUT2	이용하시려면 이용 신청을 처음부터 다시 해주시기 바랍니다.
MSI_MEMORIAL_DUN_PRIORITY	대기 순위 : ^ff0000%d^000000
MSI_MEMORIAL_DUN_NOTIFY	^ff0000%s^000000 내에 입장하지 않을 경우 신청하신 던전이 삭제 됩니다.
MSI_MEMORIAL_DUN_NOTIFY2	던전 미션 제한 시간 : 
MSI_MEMORIAL_DUN_CANCEL	메모리얼 던전 예약이 취소되었습니다.
MSI_MEMORIAL_DUN_LIVE_TIME_OUT	메모리얼 던전이 유지 시간 제한에 의해 파괴되었습니다.
MSI_MEMORIAL_DUN_ENTER_TIME_OUT	메모리얼 던전이 입장 시간 제한에 의해 파괴되었습니다.
MSI_MEMORIAL_DUN_DESTROY_REQUEST	메모리얼 던전이 삭제 되었습니다.
MSI_MEMORIAL_DUN_ERROR	메모리얼 던전에 통신 장애가 발생하였습니다. 정상적인 게임 진행을 위해 잠시 후, 재접속을 해주십시오.
MSI_FR_INVALID_SLOT	사용할 수 없는 슬롯입니다.
MSI_FR_BASELVL	Base Level이 15를 넘었습니다.
MSI_FR_INVALID_JOBLV	Job Level이 15를 넘었습니다.
MSI_FR_JOB	해당슬롯 캐릭터에 직업군의 상인이므로 게임을 할 수 없습니다.
MSI_FR_MAP	추후 사용예정
MSI_FR_ERR_MKCHAR_INVALID_SLOT	만들수 있는 케릭터 슬롯이 아닙니다.
MSI_FR_ERR_DELCHAR_INVALID_SLOT	삭제할 수 없는 케릭터 입니다.
MSI_OPEN_EQUIPEDITEM_REFUSED	상대방의 장비창이 공개되어 있지 않습니다.
MSI_OPEN_EQUIPEDITEM_REFUSE	장비창을 공개하지 않습니다.
MSI_OPEN_EQUIPEDITEM_ACCEPT	장비창을 공개합니다.
MSI_REQ_VIEW_OTHERUSER	(%s)님 장비창 보기
MSI_OTHERUSER_EQUIPED_ITEM	%s의 장착아이템
MSI_OPEN_EQUIPED_ITEM	장비창 공개
MSI_NEED_PREMIUM_SERVICE	프리미엄 서비스를 이용해 주시기 바랍니다.
MSI_FR_INVALID_MONEY	무료 사용자는 최대 50000제니까지 소유할 수 있습니다.
MSI_BATTLECHAT_ON	전장채팅 상태가 되었습니다.
MSI_BATTLECHAT_OFF	전장채팅 상태가 해제되었습니다.
MSI_MER_INFO_TYPE_MONSTER	용병정보 - 몬스터타입
MSI_RO_MAP	전체 맵 보기
MSI_MEMORIAL_DUN_CLOSE	메모리얼던젼이 CLOSE 상태입니다.
MSI_DELETE_MER	^ff0000^ff0000용병을 삭제합니다.^000000^000000 삭제하실 경우 지금까지 키운 내역이 모두 삭제됩니다. 계속하시겠습니까?
MSI_MEMORIAL_DUN_OPEN	메모리얼던젼이 OPEN 상태입니다.
MSI_PHONE_BLOCK	위의 계정은 아직 통신 안전 키에 연결되지 않았습니다.  먼저 안전 키를 해제하신 뒤 게임에 접속해 주십시오.
MSI_BAN_PC_IP_LIMIT_ACCESS	한 아이피로 접속 가능한 유저수를 초과하였습니다.
MSI_QUESTGET	새로운 퀘스트를 받았습니다
MSI_FINDTEXT_TO_SKILLDES	^777777습득조건 : 
MSI_VIEW_SKILL_DESCRIPT	스킬 설명 보기
MSI_APPLY_SKILL_UP	사용된 스킬 포인트는 다시 되돌릴 수 없습니다. 적용하시겠습니까?
MSI_1TABNAME_SKILLWND	노비스·1차직업
MSI_2TABNAME_SKILLWND	2차·전승직업
MSI_RE17	불법프로그램을 사용하였거나            혹은 해킹을 시도한 계정입니다.              블럭종료시간 : %s
MSI_RE18	불법프로그램이 실행, 바이러스 감염, 또는 해킹툴이 설치되어 있을 가능성이 있습니다. 정상 클라이언트를 실행하여 주시기 바랍니다. 함께 만드는 밝은 라그나로크가 될 수 있도록 노력하고 있습니다.
MSI_WARNING_MSG3	당신은 지금 건강한 게임 시간 대에 있습니다, 즐거운 게임이 되시길 바랍니다
MSI_PLUSONLYJOBEXP	 몬스터 사냥을 통해 얻을 수 있는 Job경험치가 30분간 1.25배로 증가합니다.
MSI_PLUSEXP14532	 몬스터 사냥을 통해 얻을 수 있는 경험치가 30분간 1.2배로 증가합니다.
MSI_PLUSEXP14533	 몬스터 사냥을 통해 얻을 수 있는 경험치가 30분간 2배로 증가합니다.
MSI_PLUSEXP12312	 몬스터 사냥을 통해 얻을 수 있는 경험치가 60분간 1.5배로 증가합니다.
MSI_NOPARTY	이 맵에서는 파티를 결성할 수 없습니다.
MSI_NOPARTY2	(%s)님은 파티에 참여할 수 없는 맵에 있습니다.
MSI_SIMPLE_CASH_SHOP	간편아이템샵
MSI_SIMPLE_POINT_SHOP_NHN	소지 한코인 : %d 한코인
MSI_SIMPLE_POINT_SHOP	소지 캐시 : %d 캐시
MSI_SIMPLE_POINT_SHOP2	무료 캐시 : %d 캐시
MSI_MAIN_USER_CANONT_LOGIN_FREE_SERVER	본서버 유저는 프리서버에 접속할수 없습니다.
MSI_INVALID_ONETIMELIMIT	유효기간이 지난 비밀번호 입니다. 다시 로그인하여주십시오.
MSI_3TABNAME_SKILLWND	3차직업
MSI_USESKILL_FAIL_TOTARGET	이 스킬을 사용할 수 없는 대상입니다.
MSI_USESKILL_FAIL_ANCILLA_NUMOVER	안실라 소유 개수가 초과하여 스킬을 사용할 수 없습니다.
MSI_USESKILL_FAIL_HOLYWATER	성수가 필요합니다.
MSI_USESKILL_FAIL_ANCILLA	안실라가 필요합니다.
MSI_USESKILL_FAIL_DUPLICATE_RANGEIN	일정거리 내에 중복될 수 없습니다.
MSI_USESKILL_FAIL_NEED_OTHER_SKILL	이 스킬을 사용하기 위해서는 다른 스킬이 필요합니다.
MSI_NO_CHATTING	이 맵에서는 채팅을 할 수 없습니다.
MSI_VET_3HOUR	3시간이 지났습니다.
MSI_VET_5HOUR	5시간이 지났습니다.
MSI_NPGAMEMON_ERROR_GAMEGUARD	게임가드 초기화 에러 또는 구버전의 게임가드 파일입니다. 게임가드 셋업파일을 다시 설치하고 게임을 실행해 보시기 바랍니다.
MSI_NPGMUP_ERROR_PARAM	ini 파일이 없거나 변조되었습니다. 게임가드 셋업파일을 설치하면 해결 할 수 있습니다.
MSI_NPGG_ERROR_COLLISION	게임가드와 충돌 프로그램이 발견되었습니다.
MSI_PROOF_ERROR	잘못된 클라이언트입니다. 정상적인 클라이언트를 실행하여 주십시요.
MSI_MOBILE_LOCKSERVER	모바일 인증을 받아주시기 바랍니다.
MSI_FAILED_MOBILE_LOCKSERVER	모바일 인증에 실패하였습니다.
MSI_USESKILL_FAIL_NEED_HELPER	이스킬은 혼자서 사용할수 없습니다.
MSI_USESKILL_FAIL_INVALID_DIR	이스킬은 특정방향으로만 사용할수 있습니다.
MSI_USESKILL_FAIL_SUMMON	더이상 소환할수 없습니다.
MSI_USESKILL_FAIL_SUMMON_NONE	소환된 구체가 존재하지 않거나 부족합니다.
MSI_USESKILL_FAIL_IMITATION_SKILL_NONE	사용가능한 모방스킬이 존재하지 않습니다.
MSI_USESKILL_FAIL_DUPLICATE	이 스킬은 중복해서 사용할수 없습니다.
MSI_USESKILL_FAIL_CONDITION	스킬을 사용할수 없는 상태입니다.
MSI_PICKUP_MAXCOUNT_LIMIT	아이템별 최대 소지량을 초과하여 가질 수 없습니다.
MSI_NPK_ERROR_NOTADMIN	관리자 권한이 없습니다. 프로그램 최초 실행은 관리자 권한으로 실행하셔야 합니다.
MSI_NPK_ERROR_DRIVERVERSION	nProtect KeyCrypt 드라이버 버전이 맞지 않습니다. 시스템 재 부팅 후에 새로 실행 시켜 주십시오.
MSI_NPK_ERROR_VERIFYVERSION	WindowXP 호환성 모드를 사용하고 계십니다. 현재 프로그램에서 호환성 모드를 제거하였습니다. 프로그램을 새로 시작해 주십시오.
MSI_DETECT_PS2KEYLOGGER	PS/2 키로거가 존재합니다.
MSI_DETECT_USBKEYLOGGER	USB 키보드 드라이버 해킹 시도가 탐지되었습니다.
MSI_DETECT_HHDUSBH	HHD 모니터링 툴이 탐지되었습니다.
MSI_USESKILL_FAIL_PAINTBRUSH	페인트붓이 필요합니다.
MSI_USESKILL_FAIL_II_SURFACE_PAINTS	서페이스페인트가 필요합니다.
MSI_USESKILL_FAIL_POS	지정한 위치에 스킬을 사용할수 없습니다.
MSI_USESKILL_FAIL_HELPER_SP_INSUFFICIENT	도우미의 SP가 부족합니다.
MSI_BAN_OVER_CHARACTER_LIST	캐릭터 선택창의 캐릭터가 %d개를 초과하면 게임에 접속할 수 없습니다. 불필요한 캐릭터를 삭제해주십시오.
MSI_USESKILL_FAIL_II_NECK_CANDY	목캔디가 필요합니다.
MSI_USESKILL_FAIL_II_MISERABLE_TEAR	안타까운눈물이 필요합니다.
MSI_USESKILL_FAIL_II_PROTECT_NECK_CANDY	목 보호 캔디가 필요합니다.
MSI_USESKILL_FAIL_GC_WEAPONBLOCKING	웨폰 블로킹의 연계로만 사용가능합니다.
MSI_USESKILL_FAIL_GC_POISONINGWEAPON	길로틴크로스의 독을 바른 무기가 필요합니다.
MSI_USESKILL_FAIL_MADOGEAR	마도기어 탑승시에만 사용가능합니다.
MSI_USESKILL_FAIL_II_VULCANBULLET	발칸블릿이 필요합니다.
MSI_USESKILL_FAIL_II_FUELGAS	마도기어 연료가 필요합니다.
MSI_USESKILL_FAIL_II_COLDSLOWERBULLET	액체냉각탄이 필요합니다.
MSI_USESKILL_FAIL_CANONBALL	캐논볼을 장전 하세요.
MSI_USESKILL_FAIL_II_MADOGEAR_ACCELERATION	미도기어 가속장치를 착용하세요.
MSI_USESKILL_FAIL_II_MADOGEAR_HOVERING_BOOSTER	호버링부스터를 착용하세요.
MSI_TOXIN	[톡신] 독 효과가 무기에 적용되었습니다.
MSI_PARALYZE	[패럴라이즈] 독 효과가 무기에 적용되었습니다.
MSI_VENOMBLEED	[베놈블리드] 독 효과가 무기에 적용되었습니다.
MSI_MAGICMUSHROOM	[매직 머쉬룸] 독 효과가 무기에 적용되었습니다.
MSI_DEATHHURT	[데스 허트] 독 효과가 무기에 적용되었습니다.
MSI_PHYREXIA	[파이렉시아] 독 효과가 무기에 적용되었습니다.
MSI_OBLIANCURSE	[오블리비언 커즈] 독 효과가 무기에 적용되었습니다.
MSI_RICHEND	[리치 엔드] 독 효과가 무기에 적용되었습니다.
MSI_USESKILL_FAIL_MADOGEAR_HOVERING	호버링상태에서만 사용가능합니다.
MSI_USESKILL_FAIL_II_MADOGEAR_SELFDESTRUCTION_DEVICE	자폭장치를 장착하세요.
MSI_USESKILL_FAIL_II_MADOGEAR_SHAPESHIFTER	셰이프쉬프터를 장착하세요.
MSI_USESKILL_FAIL_GUILLONTINE_POISON	길로틴독이 필요합니다.
MSI_USESKILL_FAIL_II_MADOGEAR_COOLING_DEVICE	냉각장치를 장착하세요.
MSI_USESKILL_FAIL_II_MADOGEAR_MAGNETICFIELD_GENERATOR	자기장필드생성기를 착용하세요.
MSI_USESKILL_FAIL_II_MADOGEAR_BARRIER_GENERATOR	베리어생성기를 착용하세요.
MSI_USESKILL_FAIL_II_MADOGEAR_OPTICALCAMOUFLAGE_GENERATOR	광학미채발생기를 착용하세요.
MSI_USESKILL_FAIL_II_MADOGEAR_REPAIRKIT	리페어키트를 착용하세요.
MSI_USESKILL_FAIL_II_MONKEY_SPANNER	몽키 스패너가 필요합니다.
MSI_SKILLINTERVAL2	[%s] 스킬을 시전 할 수 없습니다.
MSI_LEMIT_DELETE_LEVEL	%d레벨 이상은 삭제가 불가능합니다.
MSI_USESKILL_FAIL_MADOGEAR_RIDE	마도기어 탑승시에는 사용 할 수 없습니다.
MSI_DRAGONOFF	드래곤 내리기
MSI_MADOOFF	마도기어 내리기
MSI_STORE_TABNAME_0	소비
MSI_STORE_TABNAME_1	캐쉬
MSI_STORE_TABNAME_2	방어구
MSI_STORE_TABNAME_3	무기
MSI_STORE_TABNAME_4	투사체
MSI_STORE_TABNAME_5	카드
MSI_STORE_TABNAME_6	기타
MSI_ERROR_HS_TIMEOUT	클라이언트 응답시간이 초과되어 연결이 끊어집니다.
MSI_ERROR_DIFF_CLIENT	핵쉴드 파일의 버전이 맞지 않습니다. 클라이언트를 재설치 해주십시오.
MSI_USESKILL_FAIL_SPELLBOOK	마법서가 필요합니다.
MSI_USESKILL_FAIL_SPELLBOOK_DIFFICULT_SLEEP	마법서가 너무 어려워서 졸음이 몰려온다.
MSI_USESKILL_FAIL_SPELLBOOK_PRESERVATION_POINT	보존포인트가 부족합니다.
MSI_USESKILL_FAIL_SPELLBOOK_READING	더이상 마법서를 읽을수 없습니다.
MSI_USESKILL_FAIL_II_FACE_PAINTS	페이스페인트가 필요합니다.
MSI_USESKILL_FAIL_II_MAKEUP_BRUSH	분장용붓이 필요합니다.
MSI_MOBILE_TIMEOVER	대기 시간이 초과하였습니다. 다시 로그인 해주십시오.
MSI_MOBILE_ANOTHER_LOGIN	위험! 이미 동일한 계정이 로그인 중에 있습니다. 잠시 모바일 인증 진행을 멈추시고 비번을 수정한 뒤 재 로그인 해주십시오.
MSI_MOBILE_WAITING_STATE	위험! 현재 동일한 계정이 모바일 인증 대기 중에 있습니다. 잠시 모바일 인증 진행을 멈추시고 비번을 수정한 뒤 재 로그인 해주십시오.
MSI_ESC_OPTIONWND	게임 옵션창
MSI_GRAPHIC_OPTIONWND	그래픽 설정
MSI_SOUND_OPTIONWND	사운드 설정
MSI_HOTKEYWND_NOTICE1	변경 할 단축키를 누르거나, 'ESC'키를 눌러 삭제 해 주세요.
MSI_HOTKEYWND_NOTICE2	단일 키로 지정 할 수 없는 키입니다.
MSI_HOTKEYWND_NOTICE3	지정 할 수 없는 키입니다.
MSI_HOTKEYWND_NOTICE4	\'%s\'에 사용된 단축키와 중복됩니다. 바꾸시겠습니까?
MSI_HOTKEYWND_NOTICE5	저장된 단축키 조합이 초기화 됩니다. 초기화 하시겠습니까?
MSI_HOTKEYWND_TAB1	스킬바
MSI_HOTKEYWND_TAB2	인터페이스
MSI_HOTKEYWND_TAB3	이모션
MSI_HOTKEYWND_TITLE	단축키 설정 창
MSI_BGM	배경음
MSI_SOUND	효과음
MSI_SKIN	스킨
MSI_TINGONLY_ON	채팅방 입장음만 소리남 On
MSI_TINGONLY_OFF	채팅방 입장음만 소리남 Off
MSI_EXPLAIN_TINGONLY	/tingonly : 채팅방 입장음만 들을수있게됩니다
MSI_EMOTION_ROCK	/주먹
MSI_EMOTION_SCISSOR	/가위
MSI_EMOTION_WRAP	/보
MSI_EMOTION_LUV	/러브
MSI_EMOTION_MOBILE	/mobile
MSI_EMOTION_MAIL	/mail
MSI_EMOTION_ANTENNA0	/antenna0
MSI_EMOTION_ANTENNA1	/antenna1
MSI_EMOTION_ANTENNA2	/antenna2
MSI_EMOTION_ANTENNA3	/antenna3
MSI_EMOTION_HUM2	/hum
MSI_EMOTION_ABS	/abs
MSI_EMOTION_OOPS	/oops
MSI_EMOTION_SPIT	/spit
MSI_EMOTION_ENE	/ene
MSI_EMOTION_PANIC	/panic
MSI_EMOTION_WHISP	/whisp
MSI_HOTKEY_NOTHING	지정안함
MSI_USESKILL_FAIL_CART	카트장착시에만 사용가능합니다.
MSI_USESKILL_FAIL_II_THORNS_SEED	[가시나무 씨앗]이 필요합니다.
MSI_USESKILL_FAIL_II_BLOOD_SUCKER_SEED	[흡혈 식물 씨앗]이 필요합니다.
MSI_USESKILL_FAIL_NO_MORE_SPELL	더이상 시전할수 없습니다.
MSI_USESKILL_FAIL_II_BOMB_MUSHROOM_SPORE	[폭탄버섯포자]가 필요합니다.
MSI_USESKILL_FAIL_II_GASOLINE_BOOMB	[화염병]이 필요합니다.
MSI_USESKILL_FAIL_II_OIL_BOTTLE	[기름병]이 필요합니다.
MSI_USESKILL_FAIL_II_EXPLOSION_POWDER	[폭발가루]가 필요합니다.
MSI_USESKILL_FAIL_II_SMOKE_POWDER	[연막가루]가 필요합니다.
MSI_USESKILL_FAIL_II_TEAR_GAS	[최루가스]가 필요합니다.
MSI_USESKILL_FAIL_II_HYDROCHLORIC_ACID_BOTTLE	[염산병]이 필요합니다.
MSI_USESKILL_FAIL_II_HELLS_PLANT_BOTTLE	[식인식물병]이 필요합니다.
MSI_USESKILL_FAIL_II_MANDRAGORA_FLOWERPOT	[만드라고라의 화분]이 필요합니다.
MSI_YIELD_PARTYMASTER	파티장 위임
MSI_DO_YOU_REALLY_WANT_YIELD_PARTYMASTER	정말 파티장을 위임하시겠습니까?
MSI_CANNOT_YIELD_PARTYMASTER	파티장을 위임 할 수 없습니다.
MSI_FAILED_CHANGE	변경불가
MSI_USESKILL_FAIL_NEED_ITEM	[%s] %d개가 필요합니다.
MSI_ITEM_REFINING_DOWNGRADE	제련 수치가 하향 조정 되었습니다.
MSI_USESKILL_FAIL_NEED_EQUIPMENT	[%s]를 장비하고 있어야 사용할 수 있습니다
MSI_BATTLEFIELD_LIST	전장 입장 설정
MSI_CANNOT_JOINTO_BATTLEFIELD	% 전장으로 이동 할 수 없는 상태가 되어 전장 신청이 취소 되었습니다.
MSI_COMPLETED_JOINTO_BATTLEFIELD	
MSI_DIFFER_JOINTO_BATTLEFIELD	% 전장 입장이 보류 되었습니다. 다른 플레이어를 기다립니다.
MSI_STATUS_JOINTO_BATTLEFIELD	
MSI_REQ_CANCEL_JOINTO_BATTLEFIELD	확인 단추를 누르면 전장 신청이 취소됩니다. 아래 단추를 클릭해 주세요.
MSI_CANCEL_JOINTO_BATTLEFIELD	%s 전장 입장 신청이 취소되었습니다.
MSI_MOVETO_BATTLEFIELD	잠시후 %s 전장으로 이동 합니다. 공간 이동을 위한 안정적인 상태를 확보해 주시길 바랍니다. (거래 및 공간 이동 기능 일시 중지됨)
MSI_BATTLEFIELD_NAME	전장 명칭
MSI_MOVETO_SAVEPOINT	정말 이동 하시겠습니까?
MSI_VIEW_SEEK_PARTY	파티원 찾기 메세지
MSI_UNVIEW_SEEK_PARTY	파티원 찾기 메세지 옵션이 꺼져있습니다.
MSI_SEEK_PARTY_DEALY	10초간 파티 지원 딜레이가 걸려있습니다.
MSI_NOTIFY_PARTY_ROLE_MASTER	 파티장은 '%s' 님 입니다.
MSI_ERROR_SYSTEM_ERROR_BATTLEFIELD	시스템 오류로 입장 할 수 없습니다.
MSI_ERROR_FULL_ESROOM_BATTLEFIELD	대기 인원 수 초과로 입장 할 수 없습니다.
MSI_ERROR_DOUBLE_OFFER_BATTLEFIELD	이미 신청 되었습니다.
MSI_ERROR_WAIT_TIMEOUT_BATTLEFIELD	대기 시간이 초과되어 등록이 취소 되었습니다.
MSI_ERROR_BATTLEFILD_ENTER_BATTLEFIELD	입장 조건이 맞지 않아, 등록이 취소 되었습니다.
MSI_ERROR_DROP_ENTRANCESTATION_BATTLEFIELD	오류가 발생하여 등록이 취소 되었습니다.
MSI_USESKILL_FAIL_COMBOSKILL	[%s]의 연계 스킬입니다.
MSI_USESKILL_FAIL_COMBOSKILL2	특정스킬 의 연계 스킬입니다.
MSI_USESKILL_FAIL_SPIRITS	기구체 %d 개가 필요합니다
MSI_USESKILL_FAIL_SPIRITS2	기구체가 필요합니다
MSI_RUNESTONE_MAKEERROR_OVERCOUNT	최대 소지량 보다 많은 룬스톤을 제작할 수 없습니다.
MSI_ERROR_LIST_OPEN_BATTLEFIELD	전장 리스트를 받을 수 없는 상태입니다. 확인 후 다시 시도 해 주세요.
MSI_ERROR_LEVEL_LIMIT_BATTLEFIELD	레벨이 부족하여 입장 할 수 없습니다.
MSI_UPGRADESKILLERROR_MORE_FIRSTJOBSKILL	 1차 직업 스킬 %d개를 더 올려 주십시오.
MSI_UPGRADESKILLERROR_MORE_SECONDJOBSKILL	 1차 혹은 2차 직업 스킬 %d개를 더 올려 주십시오.
MSI_ITEMSYOUCANCHANGE	변환 가능한 아이템
MSI_ITEMS_FOR_CHANGE	변환할 아이템
MSI_SKILL_RECIPE_NOTEXIST	변환이 불가능한 조합 입니다.
MSI_SKILL_INVENTORY_WEIGHT_OVER	인벤토리의 무게가 너무 무겁습니다.
MSI_SKILL_INVENTORY_KINDCNT_OVER	인벤토리의 공간을 확보해주세요.
MSI_SKILL_MATERIAL_FAIL	재료가 존재하지 않습니다.
MSI_SKILL_SUCCESS	성공하였습니다.
MSI_SKILL_FAIL	실패 하였습니다.
MSI_SKILL_FAIL_MATERIAL_DESTROY	실패하여 모든 재료가 사라졌습니다.
MSI_FAILED_CHANGE_TABNAME	지정하신 탭 이름이 너무 길어 변경 할 수 없습니다.
MSI_FAILED_ADD_TAB	더 이상 추가 할 수 없습니다.
MSI_FAILED_LOCKSERVER	인증에 실패 했습니다.
MSI_BOT_CHECK	자동 입력 방지
MSI_SKILL_FAIL_MATERIAL_IDENTITY	감정이 안된 아이템은 재료로 사용할 수 없습니다.
MSI_BAN_IP_BLOCK	접속하신 IP는 라그나로크 온라인 이용이 불가능 합니다. 고객 지원 센터 또는 홈페이지로 문의 해 주십시오.
MSI_BAN_INVALID_PWD_CNT	비밀번호가 6회 이상 잘못 입력되어 잠시 동안 접속이 제한됩니다. 고객님의 개인정보를 다시 한 번 확인해 주시길 바랍니다.
MSI_MIX_ACCEPT	합성에 사용한 아이템은 소모됩니다. 괜찮겠습니까?
MSI_BOT_CHECK_NOTIC	왼쪽에 보이는 글자 및 숫자조합을 입력해주세요.
MSI_DESCRIBE_BATTLEFIELD	전장 설명 - 
MSI_BATTLEFIELD_STATUS	입장 대기 상태 - 
MSI_BATTLEFIELD_HELP	전장 입장 신청 도움말
MSI_BAN_NOT_ALLOWED_JOBCLASS	죄송합니다. 해당 직업의 캐릭터는 현재 테스트를 위해서 접속이 금지됩니다.
MSI_REMOVE_EQUIPEDITEM	모든 장비 해제
MSI_MINI_ICON	미니 아이콘
MSI_BATTLEFIELD_TEAM	진영 A  :  진영 B
MSI_WAIT_STATUS	대기열
MSI_NOTIFY_BATTLEFIELD_CANCEL	전장 신청 취소 알림
MSI_BATTLEFIELD_COUNT	전장 필요 인원
MSI_BATTLEFIELD_ATEAM_COUNT	전장 A 대기 인원
MSI_BATTLEFIELD_BTEAM_COUNT	전장 B 대기 인원
MSI_BATTLEFIELD_ATEAM_WAIT	내 대기 상황 : %d(진영 A)
MSI_BATTLEFIELD_BTEAM_WAIT	내 대기 상황 : %d(진영 B)
MSI_SHOW_BATTLEFIELD_ICON	전장 아이콘을 보여줍니다.
MSI_DONT_SHOW_BATTLEFIELD_ICON	전장 아이콘을 보여주지 않습니다.
MSI_NOTIFY_BATTLEFIELD_MOVE	전장 이동 알림
MSI_NOTIFY_BATTLEFIELD_DEFER	전장 입장 보류 알림
MSI_WHO_IS	누군가
MSI_I_RECEIVED_DAMAGE	 [%s](으)로부터 '%d'의 데미지를 받았습니다.
MSI_PARTY_RECEIVED_DAMAGE	 [%s]님이 [%s](으)로부터 '%d'의 데미지를 받았습니다.
MSI_I_GAVE_DAMAGE	 [%s]에게 '%d'의 데미지를 주었습니다.
MSI_PARTY_GAVE_DAMAGE	 [%s]님이 [%s]에게 '%d'의 데미지를 주었습니다.
MSI_DROP_ITEM	%s %d 개 드롭
MSI_CLEAR_QUEST_MONSTER	 [%s]퀘스트의 [%s]몬스터를 처치하였습니다. (%d/%d)
MSI_DELETE_QUEST	%s 퀘스트가 삭제 되었습니다.
MSI_NOTIFY_WHO	[%s]님이 
MSI_NOTIFY_EXP	'%d'의 경험치를 
MSI_NOTIFY_JOBEXP	'%d'의 잡경험치를 
MSI_GET	획득했습니다.
MSI_LOSS	상실했습니다.
MSI_NOTIFY_STEAL_COIN	 [%s](으)로부터 '%d'의 코인을 스틸했습니다.
MSI_VIEW_COMBAT_MSG	전투 메시지
MSI_VIEW_PARTY_COMBAT_MSG	파티원 전투 메시지
MSI_VIEW_GETTING_EXP_MSG	획득 경험치
MSI_VIEW_PARTY_GETTING_EXP_MSG	파티원의 획득 경험치
MSI_VIEW_QUEST_INFO_MSG	퀘스트 정보 표시
MSI_VIEW_BATTLEFIELD_INFO_MSG	전장 정보 표시
MSI_NOTIFY_TARGET_WHO	[%s]에게 
MSI_NOTIFY_SKILL_TO_TARGET	[%s] 스킬을 사용합니다.
MSI_LOCK_MOUSE	기능제한상태
MSI_UNLOCK_MOUSE	기능제한해제상태
MSI_BROADCASTING_SPECIAL_ITEM_OBTAIN	[%s]님이 [%s](으)로부터 '%s' 를 획득 했습니다.
MSI_JOB_SWORDMAN	소드맨
MSI_JOB_MAGICIAN	매지션
MSI_JOB_ARCHER	아처
MSI_JOB_ACOLYTE	어콜라이트
MSI_JOB_MERCHANT	머첸트
MSI_JOB_THIEF	씨프
MSI_JOB_KNIGHT	나이트
MSI_JOB_PRIEST	프리스트
MSI_JOB_WIZARD	위저드
MSI_JOB_BLACKSMITH	블랙스미스
MSI_JOB_HUNTER	헌터
MSI_JOB_ASSASSIN	어새신
MSI_JOB_CRUSADER	크루세이더
MSI_JOB_MONK	몽크
MSI_JOB_SAGE	세이지
MSI_JOB_ROGUE	로그
MSI_JOB_ALCHEMIST	알케미스트
MSI_JOB_BARD	바드
MSI_JOB_DANCER	댄서
MSI_JOB_RUNE_KNIGHT	룬 나이트
MSI_JOB_WARLOCK	워록
MSI_JOB_RANGER	레인져
MSI_JOB_ARCHBISHOP	아크 비숍
MSI_JOB_MECHANIC	미케닉
MSI_JOB_GUILLOTINE_CROSS	길로틴 크로스
MSI_JOB_ROYAL_GUARD	로얄가드
MSI_JOB_SORCERER	소서러
MSI_JOB_MINSTREL	민스트럴
MSI_JOB_WANDERER	원더러
MSI_JOB_SURA	수라
MSI_JOB_GENETIC	제네릭
MSI_JOB_SHADOW_CHASER	쉐도우 체이서
MSI_JOB_SWORDMAN_H	소드맨 하이
MSI_JOB_MAGICIAN_H	매지션 하이
MSI_JOB_ARCHER_H	아처 하이
MSI_JOB_ACOLYTE_H	어콜라이트 하이
MSI_JOB_MERCHANT_H	머첸트 하이
MSI_JOB_THIEF_H	씨프 하이
MSI_JOB_KNIGHT_H	로드나이트
MSI_JOB_PRIEST_H	하이프리스트
MSI_JOB_WIZARD_H	하이위저드
MSI_JOB_BLACKSMITH_H	화이트스미스
MSI_JOB_HUNTER_H	스나이퍼
MSI_JOB_ASSASSIN_H	어새신크로스
MSI_JOB_CRUSADER_H	팔라딘
MSI_JOB_MONK_H	챔피온
MSI_JOB_SAGE_H	프로페서
MSI_JOB_ROGUE_H	스토커
MSI_JOB_ALCHEMIST_H	크리에이터
MSI_JOB_BARD_H	클로운
MSI_JOB_DANCER_H	집시
MSI_JOB_NOVICE	노비스
MSI_JOB_NOVICE_H	하이노비스
MSI_JOB_SUPERNOVICE	슈퍼노비스
MSI_JOB_GUNSLINGER	건슬링거
MSI_JOB_NINJA	닌자
MSI_JOB_TAEKWON	태권소년/소녀
MSI_JOB_STAR	권성
MSI_JOB_LINKER	소울링커
MSI_SEEK_PARTY_MEMBER	파티모집
MSI_SEEK_PARTY_LIST	파티 모집 리스트
MSI_SEEK_PARTY_CHECK	파티 모집 중
MSI_FAIL_NEED_EQUIPPED_BOW	[활]을 장착한 상태여야 합니다.
MSI_FAIL_NEED_EQUIPPED_INSTRUMENT_WHIP	[악기/채찍]을 장착한 상태여야 합니다.
MSI_BAD_CHAR	영문과 숫자만 사용가능합니다.
MSI_ALRAM	알림
MSI_FAIL_BUY_ITEM_INVALID_MCSTORE	상점 정보가 정확하지 않아 아이템 구매가 실패하였습니다.
MSI_CAN_DROP_ITEM_TO_ITEMWND	소지 아이템 창에서 버릴 수 있습니다.
MSI_TIME	시간
MSI_MAP	맵
MSI_CANT_USE_WHEN_OPENED_EXCHANGEWND	거래 상태에서는 아이템 사용 및 장비 착용/해제를 할 수 없습니다.
MSI_HOTKEY_UNKOWN	미지정값
MSI_EXPLAIN_STATEINFO	/stateinfo : 상태 아이콘에 대한 설명을 보여줍니다. On Off
MSI_SHOW_STATEINFO_ON	상태 정보 On : 상태 아이콘에 대한 설명이 표시됩니다. 
MSI_SHOW_STATEINFO_OFF	상태 정보 Off: 상태 아이콘에 대한 설명이 표시되지 않습니다.
MSI_LIMIT_BUY_ITEM2	같은 아이템은 한번에 %d개 이상은 살 수 없습니다.
MSI_LIMIT_SELL_ITEM	같은 아이템은 한번에 %d개 이상은 팔 수 없습니다.
MSI_CAN_BUY_ITEM_NUM	해당 아이템의 총 구매 가능 개수는 %d개 입니다.
MSI_SAVE_HOTKEY_TO_FILE	설정한 내용은 정상 종료 시 [%s\\%s]에 저장됩니다.
MSI_CHARACTER_IS_BUSY	[%s] 님은 현재 교환 신청을 받을 수 없는 상태입니다.
MSI_RO_HELP	RO_HELP
MSI_HAVENOT_ANVIL	모루가 존재 하지 않습니다.
MSI_WHISPER_BLOCK_NOVICE_LEVEL10	노비스 레벨 10 이하는 귓속말이 금지됩니다
MSI_JOB_ATTACKER	공격
MSI_JOB_TANKER	방어
MSI_JOB_HEALER	회복
MSI_JOB_ASSISTANCE	보조
MSI_DESCRIBE_PARTY_BOOKING	파티 모집 관련 명령어
MSI_GUILD_ALLY_REQUEST_DISABLE	길드 동맹신청이 불가능합니다
MSI_GUILD_HOSTILE_REQUEST_DISABLE	길드 적대신청이 불가능합니다
MSI_FRIEND_ADD_FALSE_AGIT	아지트맵에서는 친구추가가 불가능합니다
MSI_BUYINGSTORE_MAKEWND_TITLE	구매노점 개설
MSI_BUYINGSTORE_MAKEWND_PRICE	구매가 :
MSI_BUYINGSTORE_MAKEWND_MYZENY	소지액 : 
MSI_BUYINGSTORE_MAKEWND_LIMITZENY	구매 한도액
MSI_BUYINGSTORE_MAKEWND_ADDITEM	구매할 아이템을 등록하지 않았습니다. 구매하실 아이템을 등록해 주세요
MSI_BUYINGSTORE_MAKEWND_INPUTPRICE	%s 아이템의 가격을 입력해 주세요.
MSI_BUYINGSTORE_MAKEWND_REINPUTPRICE	%s 아이템의 가격을 9999만 Zeny이하로 입력해 주세요.
MSI_BUYINGSTORE_MAKEWND_INPUTNUM	%s 아이템의 구매수량을 입력해 주세요.
MSI_BUYINGSTORE_MAKEWND_REINPUTNUM	%s 아이템의 소지수량과 구매수량의 합이 9999개 이상입니다. 9999개 이하의 수량을 입력해 주세요.
MSI_BUYINGSTORE_MAKEWND_DUPLICATEITEM	중복된 아이템이 존재합니다.
MSI_BUYINGSTORE_MAKEWND_INPUTLIMITZENY	제한 금액을 입력해 주세요
MSI_BUYINGSTORE_MAKEWND_REINPUTLIMITZENY	입력한 제한금액이 소지금액을 초과합니다. 다시 설정해 주세요
MSI_BUYINGSTORE_MAKEWND_ITEMLIST	%s  :  %s  Zeny => %s EA
MSI_BUYINGSTORE_MIRRORBUYITEMLIST	구매 가능한 아이템 목록
MSI_BUYINGSTORE_MYSHOPWND_TITLE	나의 구매노점
MSI_BUYINGSTORE_MYSHOPWND_LIMITZENY	제한금액 : %s Zeny
MSI_BUYINGSTORE_MYSHOPWND_ITEMINFO	%s %s Zeny %d 개
MSI_BUYINGSTORE_SHOPWND_TITLE	구매 노점
MSI_BUYINGSTORE_MIRRORSELLWND_TITLE	판매 가능한 아이템 목록
MSI_BUYINGSTORE_SELLWND_LIMITNUM	해당 아이템의 총 판매 가능 개수는 %d개 입니다.
MSI_BUYINGSTORE_SELLWND_LACKBUYERZENY	구매노점의 제한금액을 초과하여 판매할 수 없습니다.
MSI_BUYINGSTORE_OPEN_FAILED	구매상점 개설에 실패했습니다.
MSI_BUYINGSTORE_OVERWEIGHT	아이템의 총 무게가 %d 만큼 소지 한계량을 초과합니다. 다시 설정해 주세요.
MSI_BUYINGSTORE_TRADE_OVERLIMITZENY	제한금액만큼의 아이템을 모두 구매하였습니다.
MSI_BUYINGSTORE_TRADE_BUYCOMPLETE	아이템을 모두 구매했습니다.
MSI_BUYINGSTORE_TRADE_LACKBUYERZENY	구매자의 잔액이 부족하여 거래가 실패하였습니다.
MSI_BUYINGSTORE_TRADE_SELLCOMPLETE	%s %d개를 %dz에 판매하였습니다.
MSI_BUYINGSTORE_TRADE_OVERCOUNT	%s 아이템은 희망 구매갯수보다 수량이 많아 판매하지 못하였습니다
MSI_USESKILL_FAIL_EL_SUMMON	해당 정령을 소환할 수 없는 상태입니다.
MSI_AGAINSTSERVERSIEGEWARFARE_RESTRICTION	서버연합대전 제약사항 입니다.
MSI_OTP_MUST_6_CHAR	OTP 비밀번호는 6자리 입니다.
MSI_DB_ERROR	OTP 정보가 없습니다. 관리자에게 문의하시기 바랍니다.
MSI_OTP_FAILED	OTP 인증에 실패 했습니다.
MSI_PARTY_BOOKING_NOTIFY	파티광고가 추가되었습니다
MSI_PARTY_BOOKING_REQURT	모집 중
MSI_PARTY_BOOKING_TYPE	역할
MSI_PARTY_BOOKING_TYPE_1	1차 직업
MSI_PARTY_BOOKING_TYPE_2	2차 직업
MSI_PARTY_BOOKING_TYPE_3_1	3-1차 직업
MSI_PARTY_BOOKING_TYPE_3_2	3-2차 직업
MSI_PARTY_BOOKING_TYPE_1PLUS	전승 1차 직업
MSI_PARTY_BOOKING_TYPE_2PLUS	전승 2차 직업
MSI_PARTY_BOOKING_TYPE_ETC	기타 직업군
MSI_PARTY_BOOKING_REQURTING	모집 하기
MSI_PARTY_BOOKING_REQURT_TIP	파티원을 모집합니다.
MSI_PARTY_BOOKING_SEARCH	검색 중 - 
MSI_PARTY_BOOKING_ALL_SELECT	모두 선택
MSI_PARTY_BOOKING_ERR1	최소한 하나의 직업이 모집 중이어야 합니다.
MSI_PARTY_BOOKING_ERR2	최소 1개이상의 직업을 선택해 주셔야 합니다.
MSI_PARTY_BOOKING_ERR3	선택된 직업은 %d개입니다. 최대 6개까지만 직업을 선택할 수 있습니다.
MSI_PARTY_BOOKING_ERR4	레벨에 숫자 이외의 문자는 들어갈 수 없습니다.
MSI_PARTY_BOOKING_ERR5	레벨은 1~150 사이의 숫자를 입력해 주세요.
MSI_DISABLE_COSTUMEITEM_MAP	 해당 맵에서는 의상 장비가 보이지 않습니다.
MSI_CANNOT_EQUIP_ITEM_LEVEL	아이템을 착용할 수 있는 레벨이 아닙니다.
MSI_CANNOT_USE_ITEM_LEVEL	아이템을 사용할 수 있는 레벨이 아닙니다.
MSI_CHATMODE_ONOFF	  채팅모드 OnOff 활성화
MSI_OVER_TABSIZE	탭사이즈 크기가 초과되어 추가할 수 없습니다.
MSI_SET_CHATINFO	 창 표시 정보
MSI_SELL	판매
MSI_BUY	구매
MSI_SEARCH_STOREINFO	노점 검색
MSI_STORE_NAME	노점 이름
MSI_SEARCH_ITEM_COUNT	수량
MSI_SEARCH_ITEM_PRICE	가격
MSI_SSI_FAILED_OVER_MAXCOUNT	검색 결과가 너무 많습니다. 검색어를 자세히 입력 해 주세요.
MSI_OPEN_SEARCH_STORE	해당 노점을 여시겠습니까?
MSI_SSO_FAILED	SSO 인증에 실패하였습니다.
MSI_ZONE_MOVE_FAIL	현재 해당지역으로 이동 할 수 없습니다
MSI_SEARCH_INCLUDED	단어가 포함된 아이템 검색
MSI_WITHDREW_USERS	탈퇴한 유저입니다.
MSI_DIDNOT_AGREE	게임 이용에 동의하지 않았습니다.
MSI_ACCOUNT_DOESNOT_EXIST	존재 하지 않는 계정입니다.
MSI_AGE_RESTRICTIONS	본 게임은 12세 이용가입니다.
MSI_ACCOUNT_BLOCK	계정도용 조사를 위한 블럭상태입니다.
MSI_BUG_BLOCK	버그조사를 위한 블럭상태입니다.
MSI_PLUSEXP75	몬스터 사냥을 통해 얻을 수 있는 Base, Job 경험치가 30분간 75% 증가합니다.
MSI_PLUSEXP50	몬스터 사냥을 통해 얻을 수 있는 Base, Job 경험치가 30분간 50% 증가합니다.
MSI_FAIL_OPEN_STORE	판매(구매) 정보가 없습니다.
MSI_SSI_FAILED_SEARCH_CNT	더 이상 검색 할 수 없습니다.
MSI_SSI_FAILED_ITEM_DOES_NOT_EXIST	해당 아이템 명은 존재하지 않습니다.
MSI_SSI_FAILED_LIMIT_SERACH_TIME	아직 검색 할 수 없습니다.
MSI_SSI_TOOLTIP_OF_SERACHING_THE_CARD	카드 이름 또는 접두사(접미사)를 입력하세요
MSI_SSI_REST_OF_NUMBER_OF_SEARCHES	남은 검색 횟수 : %d
MSI_SSI_FAILED_SEARCH_STORE	검색 된 노점이 없습니다.
MSI_SSI_FAILED_PRICE_ISNOT_VALID	아이템 가격 범위가 잘못되었습니다.
MSI_GENERAL_EQUIPMENT	일반 장비
MSI_COSTUME_EQUIPMENT	의상 장비
MSI_MINUTE	분
MSI_SECOND	초
MSI_SSI_FAILED_ENTER_THE_NAME_OF_ITEM	아이템 명을 입력해 주세요.
MSI_SSI_FAILED_NAME_OF_ITEM_DOES_NOT_EXIST	해당 아이템 명은 존재하지 않습니다.
MSI_NOT_EXIST_ENTRYMAP	진입가능한 맵이 존재하지 않습니다.
MSI_SSI_FAILED_NAME_OF_CARD_DOES_NOT_EXIST	해당 카드 이름이나 접두사(접미사)는 존재하지 않습니다.
MSI_CASH_FAILED_TOTAL_CNT	 한번에 구매 가능 종류는 10개입니다.
MSI_CASH_FAILED_BUY_SOME	 일부 아이템의 구매가 실패하였습니다.
MSI_ENTER_PEOPLE_BIRTH	생년월일 6자리를 입력하세요.(예시:801122)
MSI_RESULT_FAIL_UNKNOWN	알 수 없는 오류가 발생하였습니다.
MSI_RESULT_FAIL_DATABASE	데이타 베이스 오류가 발생하였습니다.
MSI_RESULT_FAIL_GUILD	캐릭터를 삭제하기 위해서는 길드에서 탈퇴 해야 합니다.
MSI_RESULT_FAIL_PARTY	캐릭터를 삭제하기 위해서는 파티에서 탈퇴 해야 합니다.
MSI_RESULT_FAIL_CONFIGURATION	시스템 설정으로 인해 삭제할 수 없습니다.
MSI_RESULT_FAIL_DATE	아직 삭제 가능 시간이 아닙니다.
MSI_RESULT_FAIL_BIRTH	생년월일이 일치하지 않습니다.
MSI_USESKILL_FAIL_RELATIONGRADE	친밀도가 부족합니다.
MSI_USESKILL_FAIL_STYLE_CHANGE_FIGHTER	스타일체인지 파이터 상태에서만 사용가능합니다.
MSI_USESKILL_FAIL_STYLE_CHANGE_GRAPPLER	스타일체인지 그래플러 상태에서만 사용가능합니다.
MSI_PARTY_REGISTRATION_FAILED	파티등록실패
MSI_PARTY_SEARCH_FAILED	검색된 조건의 리스트가 없습니다.
MSI_PARTY_AD_DELETE_FAILED	광고삭제에 실패했습니다.
MSI_PARTY_NOT_EXIST_AD	조건에 맞는 광고가 없어 실패했습니다.
MSI_REFUSE_SSO_NOT_PAY_USER	결제 정보가 없습니다.
MSI_SCREENSHOT_FOR_EXCHANGE	교환 시 스크린샷 찍기
MSI_SCREENSHOT_FOR_EXCHANGE_CHARNAME	[거래_%s]
MSI_NOTIFY_NEO_INSURANCE_ITEM_USE	사망 시 소지한 아이템으로 경험치 손실을 막았습니다.
MSI_TALK	대화
MSI_MACRO_DUPLICATE	중복사용이 불가능합니다.
MSI_MACRO_POSTDELAY	사용제한이 걸려있습니다.
MSI_MACRO_NOT_POSTDELAY	현재 사용제한이 걸려 있지 않습니다.
MSI_SSO_ERROR_MSG	예기치 못한 사유로 인해 접속이 실패하였습니다. 관리자에게 문의해 주시기 바랍니다.
MSI_REFUSE_SSO_AUTH_INVALID_TOKEN	접속 정보 인증 실패하였습니다.
MSI_REFUSE_SSO_AUTH_INVALID_USER	가입하지 않은 사용자입니다.
MSI_REFUSE_SSO_AUTH_INVALID_AGE	나이제한 때문에 이계정으로 이서버에 접속할 수 없습니다.
MSI_NC_BUY	구매하기
MSI_NC_BLANK	장바구니 비우기
MSI_NC_FIRSTPAGE	첫 페이지
MSI_NC_LASTPAGE	마지막 페이지
MSI_NC_CAT1	신규
MSI_NC_CAT2	인기
MSI_NC_CAT3	한정
MSI_NC_CAT4	임대장비
MSI_NC_CAT5	영구장비
MSI_NC_CAT6	버프
MSI_NC_CAT7	회복
MSI_NC_CAT8	기타
MSI_NC_COST	가격
MSI_NC_NUM	수량
MSI_NC_COUNT	개
MSI_NC_FREECASH	무료 캐시 : %s C
MSI_NC_CASH	소지 캐시 : %s C
MSI_CALLMONSTER_FAIL_AREA	이 지역에서는 몬스터 소환이 불가능합니다.
MSI_BUY_CASH_FAIL2	무료캐시 사용량이 전체 금액을 초과하고있습니다
MSI_MACRO_SAVE_DATA	 설정한 내용이 [SaveData_ExMacro%d]에 저장됩니다.
MSI_ITEM_REUSE_LIMIT_SECOND	약 %d 초 후에 사용할 수 있습니다
MSI_FAIL_NEED_EQUIPPED_SPEAR	[창]을 장착한 상태여야 합니다.
MSI_USESKILL_FAIL_DRAGON	드래곤 탑승시에만 사용가능합니다.
MSI_OVER_CONNECT_USER	본 서버에 접속할 수 있는 정원이 초과되어 진입이 불가능 합니다.
MSI_AUTHENTICATE	실명 인증이 되지 않았습니다. 실명인증 사이트로 이동합니다
MSI_SELECT_SAVESLOT	저장 할 슬롯을 선택 해 주세요
MSI_BROADCASTING_SPECIAL_ITEM_OBTAIN2	%s, 축하드립니다. '%s' 를 얻으셨습니다!
MSI_NOTUSE_GROOMY	그루미상태에서는 사용할 수 없습니다
MSI_BUYINGSTORE_OVERFLOW_MONEY	구매물품의 합계금액이 케릭터가 소지할 수 있는 최대 금액을 초과하였습니다
MSI_PREVENT_PARTY_JOIN	현재 맵에서는 파티 가입이 불가능합니다.
MSI_PREVENT_PARTY_LEAVE	현재 맵에서는 파티 탈퇴가 불가능합니다.
MSI_PREVENT_PARTY_EXPEL	현재 맵에서는 파티 추방이 불가능합니다.
MSI_SDO_REALNAME	실제 성명
MSI_SDO_ID_NUMBER	신분증 번호
MSI_SDO_EMAIL	이메일
MSI_SDO_WRONG_VALUE	입력이 올바르지 않습니다
MSI_MCSTORE_FAIL_SELLER_MONEY_GIVE	상대 캐릭터가 최대 보유제니량을 초과하여 거래가 불가능합니다.
MSI_INVALID_CLASS	해당 직업이 아닙니다.
MSI_INVALID_GENDER	해당 성별이 아닙니다.
MSI_SUCCESS_AUTHENTICATE	유저님의 정보가 인증에 성공했습니다.
MSI_INVALID_REALNAME	이름이 일치하지 않습니다. 재작성 해주세요.
MSI_INVALID_IDNUMBER	신분증 번호가 일치하지 않습니다. 재작성 해주세요.
MSI_INVALID_AUTHENTICATE	현재 서비스에 이상이 있으니 잠시 후 재시도 해주세요.
MSI_CANNOT_ATTACK_IN_RIDING_STATE	 탑승 상태에서는 공격을 할 수 없습니다.
MSI_CANNOT_USE_SKILL_IN_RIDING_STATE	 탑승 상태에서는 스킬 시전을 할 수 없습니다.
MSI_STORE_PASSWORD_4_6	비밀번호는 4자리이하여야만 합니다.
MSI_SECOND_PASSWORD_LOGIN_SUCCESS	보안 인증에 성공했습니다.
MSI_SECOND_PASSWORD_MAKE_SUCCESS	보안 패스워드의 생성에 성공했습니다.
MSI_SECOND_PASSWORD_DEL_SUCCESS	보안 패스워드를 삭제했습니다.
MSI_SECOND_PASSWORD_EDIT_SUCCESS	보안 패스워드를 수정했습니다.
MSI_SECOND_PASSWORD_LOGIN_FAILED	잘못된 패스워드입니다.(%d회남음)
MSI_SECOND_PASSWORD_MAKE_FAILED	보안 패스워드의 생성에 실패했습니다.
MSI_SECOND_PASSWORD_DEL_FAILED	보안 패스워드 삭제에 실패했습니다.
MSI_SECOND_PASSWORD_EDIT_FAILED	보안 패스워드의 수정에 실패했습니다.
MSI_SECOND_PASSWORD_EDIT_RESTRICT_PW	입력하신패스워드는 사용하실수없습니다.
MSI_SECOND_PASSWORD_EDIT_PERSONALNUM_PW	주민등록번호는 사용할수없습니다.
MSI_SECOND_PASSWORD_MAKE_DUPLICATED_PW	이미 패스워드가 존재합니다.
MSI_SECOND_PASSWORD	보안 패스워드
MSI_SECOND_PASSWORD_INPUT	계정보안을 위하여 추가적인 패스워드 설정을 권장합니다.
MSI_SECOND_PASSWDRD_NOT_AVAILABLE_SUCCESS	보안 패스워드 사용을 하지 않습니다.
MSI_SECOND_PASSWDRD_NOT_AVAILABLE_FAILED	보안 패스워드 사용설정에 실패했습니다.
MSI_SECOND_PASSWDRD_AVAILABLE_SUCCESS	보안 패스워드를 사용합니다. 다음로그인부터 적용됩니다.
MSI_SECOND_PASSWDRD_AVAILABLE_FAILED	보안 패스워드 사용 설정에 실패했습니다.
MSI_SECOND_PASSWORD_INFO_1	계정보안을 위하여 추가적인 패스워드를 설정합니다.
MSI_SECOND_PASSWORD_INFO_2	아래의 숫자버튼을 마우스를 이용하여 4자리를 클릭하세요.
MSI_SECOND_PASSWORD_INFO_3	3회이상 잘못된패스워드 입력으로, 종료됩니다.
MSI_MACRO_ITEM	ITEM
MSI_MACRO_SKILL	SKILL
MSI_MACRO_TACTIC	TACTIC
MSI_MACRO_ETC	ETC
MSI_MACRO_COMBAT	COMBAT
MSI_MACRO_NON_COMBAT	NON-COMBAT
MSI_MACRO_BUFF	BUFF
MSI_MACRO_AUTO_EQUIPED	AUTO EQUIPED
MSI_MACRO_1ST_ATTACK	1st. ATTACK
MSI_MACRO_ATTACK	ATTACK
MSI_MACRO_NEXT_ATK_TIME	Next attack time : 
MSI_MACRO_WHEN_DIED	When died
MSI_MACRO_WHEN_INVITED_PARTY	When invited to a party
MSI_MACRO_PICKUP_ITEM	Pickup Item
MSI_MACRO_OVERWEIGHT	Over 85% Weight
MSI_BUSY	진행중이던 작업(NPC대화,제조...)을 종료후에 다시 시도하세요.
MSI_PLUSONLYJOBEXP2	 몬스터 사냥을 통해 얻을 수 있는 Job경험치가 %d분간 %.2f배로 증가합니다.
MSI_MACRO_SAVE	SaveData_ExMacro%d
MSI_MACRO_SAVE_DATA2	 설정한 내용이 [%s]에 저장됩니다.
MSI_SECOND_PASSWORD_LEVEL	보안레벨
MSI_RESULT_FAIL_CHAR_DELETE	현재 캐릭터는 파티 또는 길드에 가입되어 있어서 삭제가 불가능합니다.
MSI_USESKILL_FAIL_NEER_WALL	벽이나 물체 근처에서만 사용 할 수 있습니다.
MSI_SEEK_PARTY_SET	%s : 레벨 %d %s 파티구합니다.
MSI_FAIELD_RIDING_OVERLAPPED	탑승 중인 상태에서는 고삐 아이템을 사용할 수 없습니다.
MSI_USESKILL_FAIL_NEED_EXP_1PERCENT	이 스킬은 1%의 경험치가 필요합니다.
MSI_EXP_MSG	경   험   치 : 
MSI_DROP_MSG	드   롭   율 : 
MSI_DEATH_MSG	사망페널티 : 
MSI_BASIC_EXP_MSG	%d%% (PC방 %d%% + TPLUS %d%% + 프리미엄 %d%% + %s서버 %d%%)
MSI_USESKILL_FAIL_CHORUS_SP_INSUFFICIENT	 합창스킬을 시전할 파티원의 SP량이 부족합니다.
MSI_CHARACTER_IS_OVER_COUNT	상대 캐릭터의 소지 아이템 종류의 한계량 초과로 거래가 불가능합니다.
MSI_CHARACTER_IS_EACHITEM_OVER_COUNT	상대 캐릭터의 해당 아이템의 소지 한계량 초과로 거래가 불가능합니다.
MSI_PURCHASE_FAIL_EACHITEM_COUNT	해당 아이템의 소지 한계량 초과로 구입이 불가능합니다.
MSI_PARTY_FAILED_TIMEOUT	광고 등록 대기중입니다.
MSI_UNEXCEPTION_MSG1ST	아래의 파일과 텍스트내용을 함께\r\n라그나로크 공식홈페이지 -> 고객센터 -> 문의하기를\r\n이용하여 보내주시기 바랍니다.
MSI_INGAMBA_BILLING_ZSVR_ERROR	빌링시스템에 오류가 발생햇습니다(%d)
MSI_CASH_FAILED_RUNE_OVERCOUNT	룬 아이템 소유 개수가 초과 되어 구매가 실패 하였습니다.
MSI_CASH_FAILED_EACHITEM_OVERCOUNT	개별 아이템 개수가 초과 되어 구매가 실패 하였습니다.
MSI_CASH_FAILED_UNKOWN	알 수 없는 오류가 발생하여 구매가 실패 하였습니다.
MSI_CASH_FAILED_BUSY	잠시 후 다시 시도해 주십시오.
MSI_USESKILL_FAIL_NEED_EQUIPMENT_KUNAI	 쿠나이 아이템을 장착 한 상태에서만 사용 가능합니다.
MSI_SEEK_PARTY_LEVEL_HELP	모집할 최소레벨값을 입력해주세요.
MSI_FAILED_GET_ITEM_FROM_ZONEDA	존다기획사NPC 에게 아이템이 수령이 불가능합니다. 소지창의 여유공간을 확보해주세요.
MSI_USESKILL_FAIL_SIZE	이 스킬은 공성전에서만 사용 가능합니다.
MSI_USESKILL_FAIL_TOTARGET_PLAYER	이 스킬은 플레이어에게만 사용 가능합니다.
MSI_CAN_NOT_EQUIP_ITEM_FORBID	착용이 금지 된 상태로 착용 할 수 없습니다.
MSI_USESKILL_FAIL_THERE_ARE_NPC_AROUND	현재 위치에서는 상점 및 채팅방의 생성이 불가능합니다.
MSI_REPLAY_ELAPSEDTIME	Elapsed time: %d:%d:%d / %d:%d:%d
MSI_REPLAY_SPEED1_4	Speed : X 1/4 
MSI_REPLAY_SPEED1_2	Speed : X 1/2 
MSI_REPLAY_SPEED1	Speed : X 1   
MSI_REPLAY_SPEED2	Speed : X 2   
MSI_REPLAY_SPEED4	Speed : X 4   
MSI_REPLAY_SPEED8	Speed : X 8   
MSI_REPLAY_SPEED16	Speed : X 16  
MSI_REPLAY_SPEEDUNKNOWN	Speed : 알수없음
MSI_REPLAY_CHRVICEINFO	Service Info : %s
MSI_REPLAY_CHARACTERNAME	Character Name : %s
MSI_REPLAY_MAPNAME	Map Name : %s
MSI_REPLAY_RECORDTIME	Record Time: %d-%01d-%01d %d: %02d: %02d
MSI_REPLAY_PLAYTIME	Play Time: %02d: %02d: %02d
MSI_REPLAY_NOREPLAYFILE	No Replay File.
MSI_REPLAY_SERVERNOMATCH	Server No Matching
MSI_REPLAY_REPLAYOPTIONSETTING	Replay Option Setting
MSI_REPLAY_ENTERTHEFILENAME	파일 이름을 입력하세요.
MSI_REPLAY_SETREPLAYSAVEDATA	Set Replay Save Data
MSI_REPLAY_SETRECOPTION	Set Rec Option
MSI_REPLAY_GAGEPOS1	%.1f %% Pos☞:%d:%d:%d
MSI_REPLAY_GAGEPOS2	%.1f %% Pos☞:이동불가
MSI_REPLAY_START	Start
MSI_REPLAY_STOP	Stop
MSI_REPLAY_START2	Input FileName -> Start
MSI_REPLAY_OPENOPTION	Open Option
MSI_REPLAY_CLOSEOPION	Close Option
MSI_REPLAY_END	End
MSI_REPLAY_TIME	Time
MSI_REPLAY_PARTYFRIEND	파티&친구
MSI_REPLAY_CHAT	채팅
MSI_REPLAY_SHORTCUTS	단축키
MSI_REPLAY_AUTOMATICFILENAME	자동 파일명 생성
MSI_REPLAY_CHECKINGFILE	파일 중복 채크
MSI_REPLAY_THESAMEFILEEXISTS	동일한 파일이 존재 합니다.
MSI_REPLAY_RECORDSTART	Record Start
MSI_REPLAY_RECORDEND	 is Saved.
MSI_WEIGHT	Weight : %3d / %3d
MSI_TOTAL	Total : %s C
MSI_FAIL_NEED_EQUIPPED_SYURIKEN	[수리검]을 장착한 상태여야 합니다.
MSI__BASIC_MSG_BASE	Base Lv. %d
MSI__BASIC_MSG_JOB	Job Lv. %d
MSI_BASIC_MSG_ZENY	Zeny : %s
MSI_GRAPHIC_MSG_TRILINEAR	Trilinear
MSI_GRAPHIC_MSG_ATTACK	attack
MSI_GRAPHIC_MSG_SKILL	skill
MSI_GRAPHIC_MSG_ITEM	item
MSI_GRAPHIC_MSG_NOCTRL	NoCtrl
MSI_GRAPHIC_MSG_BATTLE	전장
MSI_CHARACTER_MSG_CHARACTERTOTALSLOT	(Character/Total Slot)
MSI_CHARACTER_MSG_PREMIUMSERVICE	Premium Service
MSI_CHARACTER_MSG_PREMIUM	Premium 
MSI_CHARACTER_MSG_SERVICE	Service
MSI_CHARACTER_MSG_BILLINGSERVICE	Billing Service
MSI_CHARACTER_MSG_BILLING	Billing 
MSI_MSG_COMMANDLIST	Command List
MSI_SEEK_PARTY_LEVEL	LEVEL
MSI_SEEK_PARTY_MAP	MAP
MSI_SEEK_PARTY_JOB	JOB
MSI_MSG_NOTAVAILABLE	Not Available
MSI_MSG_SUPERNOVICE_CHOPOKGI_CAPPEDLEVEL	[수호 천사의 보호] 만렙일 경우 사용할 수 없습니다.
MSI_CHANGE_CHARACTER_SLOT	정말 이동하시겠습니까?
MSI_CHANGE_CHARACTER_SLOT_FAILED	캐릭터 슬롯 이동에 실패했습니다.
MSI_CHARACTERNAME_ERROR	캐릭터 이름이 잘못 되었습니다.
MSI_QUEST_DISPLAY_ONOFF	퀘스트보기창
MSI_SHUTDOWN_ALERT_MSG	 청소년 보호법에 따라, 잠시 후 0시 부터 6시 까지 만 16세 미만 고객님들의 게임 이용이 제한됩니다.
MSI_BAN_SHUTDOWN_TEENAGER	청소년 보호법에 따라, 0시 부터 6시 까지 ^ff0000만 16세 미만 고객님들의 게임 이용이 제한^000000되며, 게임을 종료합니다.
MSI_FAILED_RENAME_BELONGS_TO_GUILD	캐릭터 이름을 변경하기 위해서는 길드에서 탈퇴 해야 합니다.
MSI_FAILED_RENAME_BELONGS_TO_PARTY	캐릭터 이름을 변경하기 위해서는 파티에서 탈퇴 해야 합니다.
MSI_FAILED_RENAME_UNKOWN	알 수 없는 오류로 캐릭터 이름 변경이 실패 하였습니다.
MSI_CHARSLOT_CHANGE_DUPLICATE	이미 캐릭터 슬롯변경이 가능한 상태입니다.(%d)
MSI_CHARNAME_CHANGE_DUPLICATE	이미 캐릭터 이름변경이 가능한 상태입니다.(%d)
MSI_FAILED_RENAME_OVER_LENGTH	변경하려는 이름의 길이가 최대크기를 초과하여 캐릭터 이름 변경이 실패 하였습니다.
MSI_FAILED_RENAME_PREVENTNAM	사용할 수 없는 단어가 포함되어 캐릭터 이름 변경이 실패 하였습니다.
MSI_FAILED_RENAME_FORBIDDEN	이름 변경이 금지된 상태이므로 캐릭터 이름 변경이 실패 하였습니다.
MSI_COMPLETE_HUNTING_QUEST	완료
MSI_PLUSEXP_VALUE	 %d분간 얻을 수 있는 경험치가 %d%% 증가합니다.
MSI_PARTY_RECALL_TIME	소환까지 %02d초남았습니다.
MSI_PARTY_RECALL_INFO	파티장이 당신을 %s (%s) 로 소환합니다.소환시 %d zeny가 소모됩니다.
MSI_RECALL_TARGET	소환대상
MSI_PARTY_BLACKLIST	차단목록
MSI_PARTY_CF_PAY	파티 광고를 등록하기 위해 %d제니가 소모됩니다.
MSI_PARTY_CF_PAY_SHORTAGE_COST	파티 광고를 하기 위한 제니가 부족합니다.
MSI_PARTY_ADD_OK	)님 파티 가입승인
MSI_PARTY_ADD_REFUSES	)님 파티 가입거부
MSI_PARTY_ITEM_VIEW	)님 장비창보기
MSI_SEEK_PARTY_MEMO_HELP	한글18글자,영문36글자 입력가능
MSI_PARTY_REQUEST	지원하기
MSI_DIRECT_CHAT	1:1대화하기
MSI_ADD_BLACKLIST	차단하기
MSI_PARTY_RECRUIT_NOT_RECALL_PAY	파티장에게 소환되기 위한 제니가 부족합니다.
MSI_PARTY_RECRUIT_MEMO_ERROR	메모란에 파티광고를 써주세요.
MSI_PARTY_RECRUIT_ERROR	파티장만이 파티광고를 등록할수있습니다.
MSI_PARTY_REFUSE_ERROR	이미 지원한 파티광고입니다.
MSI_PARTY_RECRUIT_INFO	내용
MSI_INVENTORY_TABNAME_1	장비
MSI_INVENTORY_TABNAME_3	개인
MSI_ITEM_DROP_LOCK	 아이템 버리기 잠금
MSI_PARTY_RECRUIT_ALRAM	파티원 찾기 알람
MSI_CREATE_PARTY	파티결성
MSI_WITHDRAW_PARTY	파티탈퇴
MSI_INVITE_PARTY	파티초대
MSI_PUT_PARTY_NAME_IN	파티 이름 등록
MSI_PUT_PLAYER_NAME_IN	초대할 캐릭터 이름
MSI_CHARACTER_PARTY_INVITATION_TO_JOIN	님께 파티가입 요청을 보냈습니다.
MSI_CHARACTER_REJECT_PARTY_INVITATION	님께서 파티가입을 거절했습니다.
MSI_CHARACTER_ACCEPT_PARTY_INVITATION	님께서 파티가입을 수락했습니다.
MSI_PARTY_RECRUIT_ERROR1	이미 파티모집중입니다.
MSI_PARTY_RECRUIT_ERROR2	이전 검색과 같은 조건입니다.
MSI_CHARNAME_CHANGE_FILED_GUILDMEMBER	길드 탈퇴 후 사용 가능합니다.
MSI_CHARNAME_CHANGE_FILED_PARTYMEMBER	파티 탈퇴 후 사용 가능합니다.
MSI_PARTY_RECRUIT_RECALL_ERR1	소환 유저가 소환이 안되는 맵에 있습니다.
MSI_PARTY_RECRUIT_RECALL_ERR2	현재 파티장이 있는 맵에서는 소환이 안됩니다.
MSI_PARTY_RECRUIT_RECALL_ERR3	소환거부되었습니다.
MSI_PARTY_RECRUIT_RECALL_ERR4	소환을 할 수 없습니다.
MSI_YOU_ARE_NOT_PARTYMASTER	파티초대는 파티장만 가능합니다.
MSI_NC_ITEM_SEARCH	검색할 아이템명 입력 :
MSI_PLEASE_PUT_CHARACTER_NAME_IN	캐릭터명을 입력하셔야 합니다.
MSI_PLEASE_PUT_PARTY_NAME_IN	파티이름을 입력하셔야 합니다.
MSI_GUILD_HELPER	길드 도우미
MSI_NO_GUILD_CURRENTLY_PARTICIPATED_IN	가입되어 있는 길드가 없습니다.
MSI_CREATE_GUILD	길드 결성
MIS_PUT_GUILD_NAME_IN	생성할 길드 이름
MIS_GUILD_TIP	길드 결성 도움말
MIS_GUILD_SYSTEM	길드 시스템이란
MSI_PLEASE_PUT_GUILD_NAME_IN	길드이름을 입력하셔야 합니다.
MSI_PARTY_RECRUIT_REFUSE_VOLUNTEER	지원한 파티에서 거부당했습니다.
MSI_SERVICESELECT	서비스 선택.
MSI_SHOW_MAPNAMETITLE	탈출 가능한 지역.
MSI_REPLAY_STR_REPLAYFILELIST	Replay File List
MSI_REPLAY_STR_FILEINFO	File info
MSI_REPLAY_STR_FILELIST	File List
MSI_NOT_MOVEABLE_TRADE	%s 아이템은 거래가 불가능 합니다.
MSI_GUILD_DISBAND	길드해체
MSI_PUT_DISBAND_GUILDNAME	해체할 길드 이름
MSI_JOINGUILD_NOTEXIST_USER	접속하지 않았거나 존재하지 않는 캐릭터입니다.
MSI_FAILED_SET_EFFECT_BIRD	팔콘 호출에 실패하였습니다.
MSI_BASIC_EXP_MSG_BRZ	%d%% ( 기본 100%% + 프리미엄 %d%% + %s서버 %d%% )
MSI_JOINGUILD_TARGET_USER_IN_SIEGEMAP	해당 유저는 현재 공성전에 참가하고 있습니다.
MSI_PARTY_MASTER_CHANGE_SAME_MAP	동일한 맵에서만 파티장 변경이 가능합니다.
MSI_CANNOT_PARTY_MASTER_CHANGE_IN_MAP	현재 지역에서는 파티장 변경이 불가능합니다.
MSI_ROYAL_CHIKENOFF	그리폰 내리기
MSI_TIME_TYPE3	%d월 %d일 %d시 %d분 %d초
MSI_JOINGUILD_REQ_USER_IN_SIEGEMAP	현재 공성전에 참여 중이므로 길드초대를 하실 수 없습니다.
MSI_BATTLEFIELD_MSG_REQUEST_JOINWAIT	전장에 입장 대기를 신청하셨습니다.
MSI_BATTLEFIELD_MSG_FULL	인원이 가득 찼습니다.
MSI_BATTLEFIELD_MSG_UNKNOWN_NAME	확인되지 않은 전장명입니다.
MSI_BATTLEFIELD_MSG_UNKNOWN_TYPE	확인되지 않은 신청타입입니다.
MSI_BATTLEFIELD_MSG_MAXOVER	최대 인원을 초과하였습니다.
MSI_BATTLEFIELD_MSG_JOIN_NOTLEVEL	입장 레벨이 맞지 않습니다.
MSI_BATTLEFIELD_MSG_JOIN_OVERLAP	중복 신청하셨습니다.
MSI_BATTLEFIELD_MSG_RESTART	재접속후 다시 신청하여 주시기 바랍니다.
MSI_BATTLEFIELD_MSG_NOTJOB	직업이 맞지 않습니다.
MSI_BATTLEFIELD_MSG_JOIN_ONLYBOSS	파티장이나 길드장만이 신청할 수 있습니다.
MSI_BATTLEFIELD_MSG_BUSY_PARTYMEMBER	전장을 이용 중인 팀원이 있어 신청이 불가능 합니다.
MSI_BATTLEFIELD_MSG_CANCEL_JOINWAIT	전장 입장 대기가 취소되었습니다.
MSI_BATTLEFIELD_MSG_WRONG_NAME	잘못된 전장명 입니다.
MSI_BATTLEFIELD_MSG_NOTRANK	전장 입장 대기 순위에 없습니다.
MSI_BATTLEFIELD_MSG_FAIL_CHOICE	선택하신 전장은 현재 이용하실 수 없으므로 대기가 취소됩니다.
MSI_BATTLEFIELD_MSG_CANCEL_JOIN	전장 입장을 취소하였습니다.
MSI_BATTLEFIELD_MSG_DOYOU_JOIN	전장에 입장하시겠습니까?
MSI_BATTLEFIELD_HELP1	전장 입장 신청 시스템
MSI_BATTLEFIELD_HELP2	입장 신청 및 전장으로의 공간이동 불가 상황
MSI_BATTLEFIELD_HELP3	1. 여러 종류의 전장을 동시에 신청할 수 없습니다.
MSI_BATTLEFIELD_HELP4	2. 개인 / 파티 / 길드 전장을 동시에 신청할 수 없습니다.
MSI_BATTLEFIELD_HELP5	3. 파티 전장 신청은 파티장만 신청할 수 있으며,
MSI_BATTLEFIELD_HELP6	오프라인중이거나 오프라인 된 파티원은 대기열에서 누락됩니다.
MSI_BATTLEFIELD_HELP7	4. 전장 신청은 전장 맵을 제외한 모든 곳에서 신청 가능하나,
MSI_BATTLEFIELD_HELP8	입장한 위치가 마을, 필드, 일반 던전이 아닐 경우 복귀 시 캐릭터 저장 좌표로 이동 됩니다.
MSI_BATTLEFIELD_HELP9	5. 전장의 보상 및 기타 서비스는 각 마을에 위치한 전장 모병관을 통해 전장 대기실에서 이용해 주십시오.
MSI_BATTLEFIELD_HELP10	전장 입장 신청 도움말
MSI_BATTLEFIELD_START	%s 전장이 시작됩니다.
MSI_BATTLEFIELD_DOYOU_MOVE	전장으로 이동하시겠습니까?
MSI_BATTLEFIELD_WARNINGMSG1	[주의]
MSI_BATTLEFIELD_WARNINGMSG2	현재 위치가 마을, 필드 혹은 일반던전이
MSI_BATTLEFIELD_WARNINGMSG3	아닐 경우 전장 종료 후 저장된 위치로
MSI_BATTLEFIELD_WARNINGMSG4	되돌아가게 됩니다.
MSI_BATTLEFIELD_WAIT_PLAYER	다른 이의 요청 결과를 기다리고 있습니다.
MSI_BATTLEFIELD_REQUEST_JOIN	전장 입장 요청
MSI_BATTLEFIELD_WAITTIME_D	수락대기시간:%d초
MSI_BATTLEFIELD_STATE_JOINWAIT	입장 대기 상태
MSI_BATTLEFIELD_NAME_S	전장 명칭: %s
MSI_BATTLEFIELD_MEMBER_D	전장 필요 인원: %d
MSI_BATTLEFIELD_MYRANK_D	내 대기순번: %d
MSI_BATTLEFIELD_DP_TITLE	명칭 :
MSI_BATTLEFIELD_DP_AIM	목표 :
MSI_BATTLEFIELD_DP_MEMBER	전장의 인원 구성 :
MSI_BATTLEFIELD_DP_REQUIRED	참여조건 :
MSI_BATTLEFIELD_DP_WIN	보상(승) :
MSI_BATTLEFIELD_DP_DRAW	보상(무) :
MSI_BATTLEFIELD_DP_LOSS	보상(패) :
MSI_BATTLEFIELD_DOYOU_SINGLE	전장을 개인으로 신청 하셨습니다. 맞습니까?
MSI_BATTLEFIELD_DOYOU_PALTY	전장을 파티로 신청 하셨습니다. 맞습니까?
MSI_BATTLEFIELD_DOYOU_GUILD	전장을 길드로 신청 하셨습니다. 맞습니까?
MSI_BATTLEFIELD_LIST2	전장 목록
MSI_BATTLEFIELD_D_VS_D	%d VS %d
MSI_BATTLEFIELD_LEVELDOWN_D	Base LV %d 이하
MSI_BATTLEFIELD_LEVELUP_D	Base LV %d 이상
MSI_BATTLEFIELD_LEVEL_D_D	Base LV %d ~ %d
MSI_BATTLEFIELD_LIMITLESS	제한 없음
MSI_BATTLEFIELD_MSG_NOT_JOINMAP	[해당 맵에서는 신청하실 수 없습니다.]
MSI_BATTLEFIELD_MSG_WAIT_1MM	[전장 재신청까지 약 1분의 대기시간을 필요로 합니다.]
MSI_BATTLEFIELD_MSG_PLZ_PALTYJOIN	[파티에 먼저 가입하셔야 합니다.]
MSI_BATTLEFIELD_MSG_NOT_PALTYBOSS	[파티장만 신청 가능합니다.]
MSI_BATTLEFIELD_MSG_OVER_PARTYMEMBER	[접속되어있는 파티인원수가 많습니다.]
MSI_BATTLEFIELD_MSG_PLZ_GUILDJOIN	[길드에 먼저 가입하셔야 합니다.]
MSI_BATTLEFIELD_MSG_NOT_GUILDBOSS	[길드장만 신청 가능합니다.]
MSI_BATTLEFIELD_MSG_OVER_GUILDMEMBER	[접속되어있는 길드인원수가 많습니다.]
MSI_RESERVE_CHANGE_CHARACTER_SLOT	이동예약
MSI_CHARACTER_SLOT_CHANGE	이동
MSI_CHANGE_CHARACTER_NAME	이름변경
MSI_MSG_MAKECHARCTER	Make Character
MSI_UAE_URL	http://ro.game.gnjoy.com/
MSI_UAE_SERVERSTR	(%s) Server
MSI_MERGE_ITEM	아이템 병합(모두선택 Ctrl+클릭)
MSI_SELECT_ITEM_TO_MERGE	같은 종류의 아이템을 2개 이상 선택해주세요.
MSI_MERGE_ITEM_SUCCESS	아이템 합치기에 성공했습니다.
MSI_MERGE_ITEM_FAILED_NOT_MERGE	아이템 합치기는 한번에 1종류씩만 가능합니다.
MSI_MERGE_ITEM_FAILED_MAX_COUNT	아이템의 개수가 30000개 초과 했습니다.
MSI_CHARACTER_LEFT_ROLL	좌로 회전
MSI_CHARACTER_RIGHT_ROLL	우로 회전
MSI_VIEW_BEFORE_WORLDINFO	(%s)님의 이전서버 정보보기
MSI_VIEW_BEFORE_WORLDINFO_TITLE	기존 서버 정보
MSI_VIEW_BEFORE_SERVERINFO	^ff0000기존 서버 : ^0000ff
MSI_VIEW_BEFORE_CHARNAME	^ff0000기존 캐릭명 : ^0000ff
MSI_MONSTER_HP_ON	공격한 몬스터의 HP가 표시됩니다.
MSI_MONSTER_HP_OFF	공격한 몬스터의 HP가 표시되지 않습니다.
MSI_MERGE_ITEM_FAILED_NOT_EXIST	병합 가능한 아이템이 존재하지 않습니다
MSI_NOT_EXIST_MERGE_ITEM	병합 가능한 아이템이 존재하지 않습니다.
MSI_QUESTUI_TAB_PROCESS	진행중
MSI_QUESTUI_TAB_HOLD	보류중
MSI_QUESTUI_TAB_BEST	추천
MSI_QUESTUI_TAB_EPISODE	에피소드
MSI_QUESTUI_TAB_LOCAL	로컬
MSI_QUESTUI_TAB_EVENT	이벤트
MSI_QUESTUI_TAB_NEW	신규
MSI_QUESTUI_HUNTMONSTER	사냥몬스터
MSI_QUESTUI_REWARDITEM	보상아이템
MSI_QUESTUI_NEEDITEM	필요아이템
MSI_QUESTUI_TIMELIMIT	제한시간
MSI_QUESTUI_CLOSINGTIME	마감시간
MSI_NAVIGATION_SEARCH	검색
MSI_NAVIGATION_TARGETGO	목표로 안내
MSI_NAVIGATION_ROUTEINFO	길 정보
MSI_NAVIGATION_SEARCHINFO	검색 정보
MSI_NAVIGATION_VIEWCHANGE	보기 모드 변경
MSI_NAVIGATION_LIGHTCHANGE	외부 길정보 파일 읽기
MSI_NAVIGATION_END	종료
MSI_NAVIGATION_BASE	기본 UI로 변경
MSI_NAVIGATION_MINI	간편 UI로 변경
MSI_NAVIGATION_HELP	도움말
MSI_NAVIGATION_ALL	ALL
MSI_NAVIGATION_MAP	Map
MSI_NAVIGATION_NPC	Npc
MSI_NAVIGATION_MOB	Mob
MSI_NAVIGATION_SETSTRING	검색 단어 설정 (Ex: 단어 단어 ...
MSI_NAVIGATION_SCROLL	Scroll
MSI_NAVIGATION_USESCROLL	던전이동 스크롤 사용 적용
MSI_NAVIGATION_SERVICE	Service
MSI_NAVIGATION_USESERVICE	위치 이동 서비스 허용
MSI_NAVIGATION_PLANE	Plane
MSI_NAVIGATION_USEPLANE	비공정 이동 적용
MSI_NAVIGATION_TARGETUNKNOWN	>> 목표 정보를 읽지 못함!
MSI_NAVIGATION_GOING	<< 안내중 >>
MSI_NAVIGATION_SEARCHING	<< 검색중... >>
MSI_NAVIGATION_UN	-----------
MSI_NAVIGATION_NAVI	Navigation
MSI_NAVIGATION_SEARCHRESULT_D	== 검색 결과(%d)==
MSI_NAVIGATION_NPC_S_S	Npc)%s:%s
MSI_NAVIGATION_MOB_S_S	Mob)%s:%s
MSI_NAVIGATION_MAP_S	Map)%s
MSI_NAVIGATION_RESULTINFO	======== 결과 정보 ==========
MSI_NAVIGATION_LENGTH	거리   : %d Sell %d WarpMove
MSI_NAVIGATION_TARGETMAP_S_S	목표맵: %s(%s)
MSI_NAVIGATION_TARGET_S_D_D	목표   : %s(%d, %d)
MSI_NAVIGATION_BOSS	보스
MSI_NAVIGATION_NORMAL	일반
MSI_NAVIGATION_TARGET_S_S	목표   : %s(%s)
MSI_NAVIGATION_TARGET_D_D	목표: (%d, %d)
MSI_NAVIGATION_GOINFO	======= 길 안내 정보 =======
MSI_NAVIGATION_ITEM_S_S	%2d) Item:%s => %s 사용!
MSI_NAVIGATION_D_S_D_D_D_D	%2d) %s(%d,%d)=>(%d,%d)
MSI_NAVIGATION_E_D_S_D_D_D_D	E%2d) %s(%d,%d)=>(%d,%d)
MSI_NAVIGATION_E_D_S	E%2d) %s
MSI_NAVIGATION_GOEXIT	안내중 입니다! 종료 하시겠습니까?
MSI_NAVIGATION_HELPTITLE	내비게이션 도움말
MSI_NAVIGATION_HELP1	------------------- 명령어 --------------------
MSI_NAVIGATION_HELP2	1. /navigation      /navi
MSI_NAVIGATION_HELP3	  ex)/navi prontera 100/100 -> 맵이름, 100/100
MSI_NAVIGATION_HELP4	  기본 명령어는 제니, 비공정 검색을 기본으로 합니다.
MSI_NAVIGATION_HELP5	2. /navigation2      /navi2
MSI_NAVIGATION_HELP6	  ex) /navi2 prontera 100/100 1/1/1
MSI_NAVIGATION_HELP7	-> 맵이름, 위치(100/100), scroll/zeny/plane (1:사용함 0: 사용안함)
MSI_NAVIGATION_HELP8	3. $$all   모든 항목 출력 (Type 구분 항목으로 출력 종류 구분 가능.)
MSI_NAVIGATION_HELP9	4. $$lv30   해당 레벨의 몬스터 출력
MSI_NAVIGATION_HELP10	5. $$lv20~30   해당 레벨 범위의 몬스터 출력
MSI_NAVIGATION_HELP11	-------------------  설명  --------------------
MSI_NAVIGATION_HELP12	1.검색 종류는 전체, 맵, Npc, 몬스터 으로 분류 된다.
MSI_NAVIGATION_HELP13	2.명령어로 검색한다. 규칙은 검색 하려는 문자열이 모두 포함된 정보를 출력 한다.
MSI_NAVIGATION_HELP14	  ex) 프론 카프 -> 검색 결과 프론테라의 카프라를 모두 출력 한다.
MSI_NAVIGATION_HELP15	3.리스트에서 항목을 선택하면 정보가 출력된다.
MSI_NAVIGATION_HELP16	  출력 되고 있는 목표가 있을때 안내 버튼을 클릭하면 해당 목표로 길을 안내 한다.
MSI_NAVIGATION_HELP17	4.scroll/ zeny/ plane 상자를 원하는 만큼 체크하여 더 빠른 경로를 안내 받을 수 있다.
MSI_NAVIGATION_HELP18	5.안내 버튼이 눌러지면 결과 리스트창은 길안내 리스트 장으로 변경 된다.
MSI_NAVIGATION_HELP19	6.검색 리스트창 하단 버튼을 이용하여
MSI_NAVIGATION_HELP20	 [결과 리스트 창] <-> [길 안내 정보 창] 으로 보기 모드 변경 가능하다.
MSI_NAVIGATION_LEVEL_D_BOSS	Level:%d (보스)
MSI_NAVIGATION_LEVEL_D_NORMAL	Level:%d (일반)
MSI_NAVIGATION_PROPERTY1	수속성%d
MSI_NAVIGATION_PROPERTY2	지속성%d
MSI_NAVIGATION_PROPERTY3	화속성%d
MSI_NAVIGATION_PROPERTY4	풍속성%d
MSI_NAVIGATION_PROPERTY5	독속성%d
MSI_NAVIGATION_PROPERTY6	성속성%d
MSI_NAVIGATION_PROPERTY7	암속성%d
MSI_NAVIGATION_PROPERTY8	염속성%d
MSI_NAVIGATION_PROPERTY9	불사%d
MSI_NAVIGATION_PROPERTY0	무속성%d
MSI_NAVIGATION_SCALE1	중형
MSI_NAVIGATION_SCALE2	대형
MSI_NAVIGATION_SCALE0	소형
MSI_NAVIGATION_RACE1	불사형
MSI_NAVIGATION_RACE2	동물형
MSI_NAVIGATION_RACE3	식물형
MSI_NAVIGATION_RACE4	곤충형
MSI_NAVIGATION_RACE5	어패형
MSI_NAVIGATION_RACE6	악마형
MSI_NAVIGATION_RACE7	인간형
MSI_NAVIGATION_RACE8	천사형
MSI_NAVIGATION_RACE9	용족
MSI_NAVIGATION_RACE0	무형
MSI_NAVIGATION_MOVECLICK	%s 이동 클릭
MSI_NAVIGATION_NPCMOVE	Npc 이동 서비스 이용
MSI_NAVIGATION_NPCCLICK	NPC 클릭
MSI_NAVIGATION_S_MOVE	%s 이동
MSI_NAVIGATION_PLANEMOVE	비공정 이동
MSI_NAVIGATION_WARPUSE	워프 이용
MSI_NAVIGATION_TARGETPOINT_D_D	도착점 : ( %d %d )
MSI_NAVIGATION_UNKNOWNMAP	내비게이션이 지원 되지 않는 지역 입니다.
MSI_NAVIGATION_RS_UNKNOWN	찾고자 하는 목적이 불분명 합니다.
MSI_NAVIGATION_RS_NOTSAMEMAP	매칭이 맞지 않는 맵이다.
MSI_NAVIGATION_RS_FAILSTARTDATA	출발 지역에 대한 정보 설정 실패!
MSI_NAVIGATION_RS_FAILTARGET	도착 지점에 대한 정보 설정 실패!
MSI_NAVIGATION_RS_FAILROUTE	길 찾기 실패
MSI_NAVIGATION_RS_FAILPLAYER	플레이어 위치 찾기 실패
MSI_NAVIGATION_RS_NODATA	내비게이션에 정보가 없습니다.
MSI_NAVIGATION_RS_MAPNOTNAVIGATION	해당 맵은 길찾기가 지원 되지 않는 맵입니다.
MSI_NAVIGATION_RS_FAILTARGETROUTE	목표를 지정 하시기 바랍니다.
MSI_NAVIGATION_RS_SUCCESS	도착.
MSI_NAVIGATION_RS_START	길 안내가 시작 되었습니다.
MSI_NAVIGATION_RS_MOBTARGETMAP	찾고자 하는 몬스터가 있는 맵 입니다.
MSI_NAVIGATION_RS_TARGETMAP	찾고자 하는 맵이 해당 맵 입니다.
MSI_NAVIGATION_RS_SCROLL	아이템을 사용하여 이동하여 주시기 바랍니다.
MSI_NAVIGATION_RS_ROUTE_SUCCESS	안내하는 위치로 이동하시기 바랍니다.
MSI_NAVIGATION_RS_MAPTMAP_SUCCESS	목표 맵에 도착하였습니다.
MSI_NAVIGATION_RS_NPCTMAP_SUCCESS	찾고자 하는 Npc가 있는 맵에 도착 하였습니다. Npc로 이동하시기 바랍니다.
MSI_NAVIGATION_RS_MOBTMAP_SUCCESS	찾고자 하는 Mob이 서식하는 맵에 도착 하였습니다.
MSI_NAVIGATION_RS_POSTMAP_SUCCESS	이전과 동일한 목표 입니다.
MSI_NAVIGATION_RS_SAMETARGET	가리키는 방향으로 가시기 바랍니다.
MSI_NAVIGATION_RS_HERE	목표가 여기 입니다.
MSI_NAVIGATION_PRINT_S	Navigation >: %s
MSI_NAVIGATION_PRINT_GO_S	Navigation >: 안내하는 %s(을)를 이용하여
MSI_NAVIGATION_PRINT_MAP_S	Navigation >: 맵(%s)으로 이동하시기 바랍니다
MSI_NAVIGATION_PRINT_SELECTMAP_S	Navigation >: 맵(%s)을 선택하여 이동 하시기 바랍니다
MSI_NAVIGATION_PRINT_PLANE	Navigation >: 비공정으로 이동 하시기 바랍니다
MSI_NAVIGATION_PRINT_WARP	Navigation >: 워프를 이용하여 다음 지역으로 이동하시기 바랍니다.
MSI_NAVIGATION_PRINT_ITEM	Item: 
MSI_NAVIGATION_ZZ	$$
MSI_NAVIGATION_ZZLV	$$lv
MSI_NAVIGATION_ZZLIMIT	~
MSI_NAVIGATION_ZZALL	$$all
MSI_SHOP_ITEM_BAY_TITLE	구매 확인서
MSI_SHOP_ITEM_BAY_MAG1	구입하려는 아이템들의 총가격은
MSI_SHOP_ITEM_BAY_MAG2	Zeny 입니다.
MSI_SHOP_ITEM_BAY_MAG3	구입하시겠습니까?
MSI_BASIC_EXP_MSG2	%.1f%% (PC방 %.1f%% + TPLUS %.1f%% + 프리미엄 %.1f%% + %s서버 %.1f%%)
MSI_CARDWIN	카드 북
MSI_PERSONAL_INFORMATION_MSG_CHN	%d%% [ ( 기본 100%% + %s서버 %d%% ) * 활성 %.1f ]
MSI_PERSONAL_INFORMATION_MSG_CHN_DEATH	%d%% [ 기본 100%% + %s서버 %d%% ]
MSI_CAUTION_PKZONE	이곳은 PK 지역입니다. 미성년자는 자발적으로 떠나주시기 바랍니다.
MSI_FATIGUE	피로도
MSI_FATIGUE_LEVEL_ZERO	건강상태 이며 게임수익은 100%입니다.
MSI_FATIGUE_LEVEL_HALF	지금은 피로상태이므로 손님의 게임수익은 50% 떨어집니다. 건강을 위하여 적당한 휴식 바랍니다.
MSI_FATIGUE_LEVEL_FULL	지금은 비건강상태이므로 손님의 건강을 위하여 게임오프라인을 원합니다. 계속 온라인상태에 있으면 건강에 손상을 주므로 게임 수익은 0%으로 떨어지며 게임 오프라인 5시간후에 다시 회복됩니다.
MSI_FATIGUE_MESSAGE0	접속시간 %d 분이 되었습니다.
MSI_FATIGUE_MESSAGE1	접속시간 %d 시간이 되었습니다.
MSI_FATIGUE_MESSAGE2	접속시간 %d 시간 %d 분이 되었습니다.
MSI_EXPLAIN_MONSTERHP	/monsterhp : 공격한 몬스터의 HP정보를 표시합니다. On Off
MSI_SKILLPOINT2	스킬포인트 : 
MSI_BAN_BILLING_SERVER_ERROR	인증서버로 부터의 응답이 없습니다. 다시 시도해 주세요
MSI_REFUSE_CHANGE_PASSWD_FORCE	암호를 변경하여 주시기 바랍니다.
MSI_REFUSE_CHANGE_PASSWD_SITE	http://www.ragnarok.co.kr
MSI_PLANNED_TIME_SHUTDOWN	고객님께서는 현재 접속금지 시간입니다.
MSI_SHOUTDOWN_TIME	셧다운제도에 의해 고객님의 게임제한 시간은 %1.2d-%1.2d-%1.2d %1.2d:%1.2d:%1.2d에 게임이 종료될 예정입니다.
MSI_PARTIAL_SHOUTDOWN_TIME	고객님의 계정은 선택적 셧다운이 적용된 계정이며, 잔여시간은 %1.2d시간 %1.2d분입니다. 게임 이용에 참고해주시기 바랍니다.
MSI_MENU_REPLAYWND	리플레이
MSI_MENU_MACROWND	매크로
MSI_MENU_WEBBROWSERWND	Webbrowser
MSI_MENU_NAVIGATIONWND	내비게이션
MSI_MENU_UAEURLWND	UAEURL
MSI_CLAN_INFOMANAGE	 클랜정보 
MSI_CLAN_LEVEL	클랜레벨
MSI_CLAN_NAME	클랜명
MSI_CLAN_MARK	클랜마크
MSI_ALLY_CLAN	동맹클랜
MSI_HOSTILITY_CLAN	적대클랜
MSI_SEND_TO_CLAN	클랜에게 보냄
MSI_CLAN_MASTER_NAME	마스터이름
MSI_CLAN_NUM_MEMBER	조합원수
MSI_CLAN_MANAGE_LAND	관리영지
MSI_VIEW_CLAN_MSG	클랜 채팅 메시지 표시
MSI_TWWEB_WARRING	충전 페이지로 이동합니다.
MSI_TWWEB_URL	https://gfb.gameflier.com/Billing/ingame/index_new.asp?
MSI_STR_MAKECHARACTER	캐릭터 만들기
MSI_CHR_DELETE_RESERVED_FAIL_CHARNAME	캐릭명이 일치하지 않습니다.
MSI_CHR_DELETE_RESERVED_INPUTCONFIRMSTR_WND_TITLE	캐릭터명을 입력하세요
MSI_SELECT_SEX	성별 선택 창
MSI_SPRITE_ALTER	파일의 위변조가 감지 되었습니다.
MSI_CONFIRM_TO_OPEN_EVENT_ITEM	해당 아이템을 개봉하여 획득되는 아이템들은 캐릭터 귀속 아이템 (창고이동 불가능) 입니다. 본 캐릭터에 사용하시는 것이 맞으신지 확인해주시기 바랍니다. 상자를 개봉하시겠습니까?
MSI_GAME_SETTING	게임 설정
MSI_SYSTEM_SETTING	게임 시스템
MSI_COMMAND_SETTING	게임 커맨드
MSI_COMMAND_LIST	게임 커맨드 ON/OFF
MSI_MACRO_LIST	매크로
MSI_EXCHANGEITEM_DENY_MAP	이지역은 아이템교환이 금지 되어 있습니다
MSI_CART_USE_DENY_MAP	이지역은 카트이용이 금지 되어 있습니다
MSI_BLOCK_SUNMOONSTAR_MIRACLE	이지역은 태양과달과별의 기적 효과가 발생하지 않습니다.
MSI_RANKING_BOARD	랭킹 보드
MSI_RANKING_NUMBER	순위
MSI_RANKING_NAME	이름
MSI_RANKING_POINT	포인트
MSI_RANKING_BLACKSMITH	BlackSmith
MSI_RANKING_ALCHEMIST	Alchemist
MSI_RANKING_TAEKWON	Taekwon
MSI_RANKING_KILLER	Killer
MSI_RANKING_BATTLE_7VS7_ALL	7 vs 7
MSI_RANKING_RUNE_KNIGHT	RuneKnight
MSI_RANKING_WARLOCK	Warlock
MSI_RANKING_RANGER	Ranger
MSI_RANKING_MECHANIC	Mechanic
MSI_RANKING_GUILLOTINE_CROSS	GuillotineCross
MSI_RANKING_ARCHBISHOP	Archbishop
MSI_RANKING_ROYAL_GUARD	RoyalGuard
MSI_RANKING_SORCERER	Sorcerer
MSI_RANKING_MINSTREL	Minstrel
MSI_RANKING_WANDERER	Wanderer
MSI_RANKING_GENETIC	Genetic
MSI_RANKING_SHADOW_CHASER	ShadowChaser
MSI_RANKING_SURA	Sura
MSI_RANKING_KAGEROU	Kagerou
MSI_RANKING_OBORO	Oboro
MSI_RANKING_SELECT	Select Ranking Type
MSI_RANKING_TYPE	Ranking Type
MSI_WAITING_FOR_ENTER_TO_CHARACTER_SEVER_IN_SEC	현재 접속 인원이 가득 찼습니다.           ^0000ff현재 대기순위 : %d                    예상 대기시간 : %d초
MSI_WAITING_FOR_ENTER_TO_CHARACTER_SEVER_IN_MIN	현재 접속 인원이 가득 찼습니다.           ^0000ff현재 대기순위 : %d                    예상 대기시간 : %d분 %d초
MSI_CBT_ACTIVE_USER_CHECK	CBT 초청 유저가 아닙니다
MSI_NAVIGATION_HELP_1	 -------------- Navigation 명령어 --------------
MSI_NAVIGATION_HELP_2	/navigation    /navi  :  /navi yuno 100/100           ->> 맵이름, 위치(100/100)
MSI_NAVIGATION_HELP_3	/navigation2  /navi2 :  /navi2 yuno 100/100 1/1/1 ->> 맵이름, 위치(100/100), scroll/zeny/plane (1:사용함 0: 사용안함)
MSI_NAVIGATION_HELP_4	 -------------- Navigation 검색창 명령어 -------
MSI_NAVIGATION_HELP_5	$$all         : 모든 항목 출력 (Type 구분자에서 출력 종류를 나눌수 있다.)
MSI_NAVIGATION_HELP_6	$$lv30       : 해당 레벨의 몬스터 출력 (숫자는 변경 가능)
MSI_NAVIGATION_HELP_7	$$lv20~30  : 해당 레벨 범위의 몬스터 출력 (숫자는 변경 가능)
MSI_RANKING_BATTLE_1VS1_ALL	1 vs 1
MSI_SHADOW_EQUIPMENT	특수 장비
MSI_CHARACTERERROR_JOB	%d 번째 캐릭터의 직업 정보가 이상합니다. 고객센터로 문의 부탁 드립니다. ErrorCode(%d)
MSI_NAVIGATION_ALL_S	(%s) %d / %d
MSI_NAVIGATION_ALL_SD	%s-%s(%d/%d)
MSI_REFUSE_OVER_USERLIMIT	접속자 수 초과로 서버에 더이상 접속할 수 없습니다.
MSI_REFUSE_ERRORCODE	서버접속 실패 (%d)
MSI_REFUSE_DISCONNECT_KEEP_TIME	로그인 허용시간 초과
MSI_REFUSE_WEB_AUTH_FAILED	로그인 중 인증서버로부터 인증이 실패하였습니다.
MSI_GUILDNAME_CHECK	길드이름에 공백문자를 사용할 수 없습니다.
MSI_BILLING_CHN_1	고객님 안녕하세요!
MSI_BILLING_CHN_2	고객님의 이용 시간은 %d년 %d 월 %d일 %d:%d 에 종료됩니다.
MSI_BILLING_CHN_3	고객님의 이용 시간은 아직 많이 남았으니 안심하고 플레이하세요!
MSI_BILLING_CHN_4	고객님의 이용 시간은 이번 주 내로 종료 됩니다. 종료 전에 충전을 하시기 바랍니다.
MSI_BILLING_CHN_5	고객님의 이용 시간은 24시간 내에 종료됩니다. 빨리 충전하시기 바랍니다.
MSI_BILLING_CHN_6	현재 고객님의 이용 시간은 %d시간 남았습니다. 정상적인 게임 이용을 위해 충전을 하시기 바랍니다.
MSI_BILLING_CHN_7	현재 고객님의 이용 시간은 %d분 남았습니다. 이용시간이 끝난 후 강제적으로 종료됩니다. 정상적인 게임 이용을 위해 충전을 하시기 바랍니다.
MSI_BILLING_CHN_8	고객님의 이용 시간은 %d시간 %d분 남았습니다.
MSI_BASIC_EXP_MSG_THAI	%d%% ( 기본 100%% + PC방 %d%% + 프리미엄 %d%% + %s서버 %d%% )
MSI_CHN_BILLING_EXPIRE_TIME	고객님의 이용 시간은 %d시간 %d분 후에 종료됩니다.
MSI_CHN_BLOCK_FOREVER	유저님의 계정은 영구 접속금지 되였습니다
MSI_CHN_BLOCK	유저님의 계정은 접속금지 되였습니다\n 해지 시간 : %04d-%02d-%02d %02d:%02d
MSI_WORLDMAP_MSG1	몬스터(Tab)
MSI_WORLDMAP_MSG2	맵(Alt)
MSI_WORLDMAP_MSG3	안내 정보
MSI_WORLDMAP_MSG4	검색 정보
MSI_WORLDMAP_MSG5	비공정
MSI_WORLDMAP_MSG6	카프라
MSI_WORLDMAP_MSG7	(도착)
MSI_NAVIGATION_MOB_S_S_S	Mob)%s:%s(%s)
MSI_NAVIGATION_NUM	분포도:%s
MSI_NAVIGATION_NUM1	매우많음
MSI_NAVIGATION_NUM2	많음
MSI_NAVIGATION_NUM3	보통
MSI_NAVIGATION_NUM4	적음
MSI_NAVIGATION_NUM5	매우적음
MSI_BANK_SYSTEM_ERROR	은행을 이용할 수 없습니다. 잠시 후 다시 시도하세요.
MSI_BANK_WITHDRAW_NO_MONEY	은행 잔고가 부족합니다.
MSI_BANK_DEPOSIT_NO_MONEY	보유한 Zeny 가 부족해서 입금할 수 없습니다.
MSI_BANK_DEPOSIT_ZERO	1 Zeny 이상 입금 가능합니다.
MSI_BANK_WITHDRAW_ZERO	1 Zeny 이상 출금 가능합니다.
MSI_BANK_OVER_INT_MAX	보유 Zeny 는 2,147,483,647 Zeny를 넘을 수 없습니다.
MSI_REFUSE_MOTP_LOCK	your account is lock by mobil otp
MSI_REFUSE_MOTP_AUTH_FAIL	MOTP auth fail
MSI_JOBPLUSEXP_VALUE	%d분간 몬스터에게 얻을 수 있는 Job경험치가 %d%% 증가합니다.
MSI_BANK_MY_ZENY	소지 Zeny : %s Zeny
MSI_BANK_ZENY	Zeny
MSI_BANK_WARNING	최대 2,147,483,647 Zeny 까지만 보관이 가능합니다.
MSI_NEED_MORE_BULLET	총알이 부족합니다.
MSI_OVERPRICE_MAX	10억제니 이상 입력하셔도 가격은 10억 제니로 고정됩니다.
MSI_NOT_VALID_AUTH_TICKET	AuthTicket is Not Vaild
MSI_STEAMAGENCY_ERROR	ErrorCategory : %d, ErrorCode : %d (%d,%d,%d,%d)
MSI_BASIC_EXP_MSG_INDONESIA	%d%% ( Basic 100%% + Premium %d%% + PCCafe %d%% + %s Server %d%% )
MSI_RECEIVEITEM_VALUE	 %d분간 몬스터 사냥을 통해 얻을 수 있는 기본 아이템의 드롭률이 %d%%로 증가합니다.
MSI_RECEIVEITEM_VALUE_1	 %d시간 %.2d분간 몬스터 사냥을 통해 얻을 수 있는 기본 아이템의 드롭률이 %d%%로 증가합니다.
MSI_WARNING_PRICE1	%s 의 가격이
MSI_WARNING_PRICE2	100000000
MSI_WARNING_PRICE3	 ^ff0000%d^0000ff억
MSI_WARNING_PRICE4	10000000
MSI_WARNING_PRICE5	 ^ff0000%d^0000ff천만
MSI_WARNING_PRICE6	^0000ffZeny 이상^000000입니다.\n입력금액이 맞습니까?
MSI_WARNING_PRICE7	천만Zeny이상 안전확인
MSI_AMERICA_CASHSHOP_URL	https://www.warpportal.com/account/login.aspx?ReturnUrl=%2faccount%2fpayment.aspx
MSI_AMERICA_CASHSHOP_URL_STEAM	https://kepler.warpportal.com/ro1/purchase/?step=1&steamid=%lld&accountname=
MSI_QUEST_INFO_01	지상의 끝, 스플랑디드와 부유대륙 알프헤임을 잇는 다리, 비프로스트에 생겨난 거대한 균열, 그리고 근원을 알 수 없는 미궁숲. 
MSI_QUEST_INFO_02	이것은 여행의 끝을 알리는 표식인가, 새로운 세계를 여는 지표인가! 수호자는 노랫말 같은 유혹에 점차 넋을 잃어가고 있었다. 
MSI_QUEST_INFO_03	수천 년의 세월이 흐르는 동안, 그 스스로가 홀로 안간힘을 쓰며 지켜낸 것이 무엇이었는지, 봉인 되어 긴 시간을 갇혀버린 것은 오히려 자신이 아니었는지 혼란을 느끼고 있었다. 
MSI_QUEST_INFO_04	유혹의 노랫말이 최고조에 이르렀을 때, 지상의 끝 스플랑디드와 부유대륙 알프헤임을 잇는 다리, 비프로스트에 거대한 균열이 생겨났고, 그로 인해 두 세계간의 왕래가 끊기면서 사람들은 큰 불편을 겪게 되었다. 
MSI_QUEST_INFO_05	비프로스트의 통로는 이제 미궁숲 뿐. 근원조차 알 수 없는 그곳을 무사히 통과 한 사람은 지금까지 아무도 없었다. 
MSI_QUEST_INFO_06	숱한 모험가들을 집어 삼킨 혼돈의 지옥, 미궁숲은 그 속을 방황하는 이름 모를 여인의 마음처럼 더욱 깊고 혼란스럽게 확장되고 있었다.
MSI_BANK_CHECK_NUM	숫자만 입력 가능합니다.
MSI_BANK_PROHIBIT	교환창 또는 상점이 활성화 된 상태에서는 입출금을 하실수 없습니다.
MSI_QUEST_INFO_00	바로가기
MSI_ITEM_COMPARISON	아이템 비교
MSI_WRONG_GUN	현재 장착하려고 하는 총기가 장착하고 있는 탄환에 맞지 않습니다
MSI_WRONG_BULLET	현재 장착하려고 하는 탄환이 장착하고 있는 총기와 맞지 않습니다
MSI_BUYINGSTORE_MAKEWND_ADD_GOODS	판매할 아이템을 등록하지 않았습니다. 판매하실 아이템을 등록해 주세요
MSI_ITEM_IN_MAIL_SYSTEM	ITEM
MSI_GUILD_STORAGE_OPEN_ERROR	길드 창고를 이용할 수 없습니다.
MSI_GUILD_STORAGE_OPEN_NO_JOIN_GUILD	길드에 가입되어 있지 않습니다. 가입 후 이용해주세요.
MSI_GUILD_STORAGE_WARNING_USING_ANOTHER_MEMBER	다른 길드원이 사용중입니다. 잠시 후 이용해주세요.
MSI_GUILD_STORAGE_PERMISSON	창고권한
MSI_GUILD_STORAGE_TITLE	길드창고
MSI_GUILD_STORAGE_PERMISSON_WARNING_MSG	길드창고의 사용 권한이 없습니다.
MSI_BARGAINSALE_TOOLWND_TITLE	한정판매 등록창
MSI_BARGAINSALE_TOOLWND_DB_NAME	아이템 DB명
MSI_BARGAINSALE_TOOLWND_DB_NUMBER	아이템 DB번호
MSI_BARGAINSALE_TOOLWND_SELL_COUNT	판매 갯수
MSI_BARGAINSALE_TOOLWND_SELL_STARTTIME	판매 시작시간
MSI_BARGAINSALE_TOOLWND_SELL_PERIODTIME	판매할 시간
MSI_BARGAINSALE_TOOLWND_INPUT_COUNT_MSG	판매할 갯수를 입력해 주세요
MSI_BARGAINSALE_TOOLWND_INPUT_STARTTIME_MSG	판매 시작시간을 입력해 주세요
MSI_BARGAINSALE_TOOLWND_WRONG_RANGE_MSG	판매 시작시간의 범위가 맞지 않습니다
MSI_BARGAINSALE_TOOLWND_INPUT_PERIODTIME_MSG	판매할 시간을 입력해 주세요
MSI_BARGAINSALE_TOOLWND_INPUT_ITEMDBNAME_MSG	Item DB Name을 입력해 주세요
MSI_BARGAINSALE_TOOLWND_ITEMID_CHECK_FAILED_MSG	Item ID 조회에 실패하였습니다. 확인 후 다시 시도해 주시기 바랍니다
MSI_BARGAINSALE_TOOLWND_RESULT_FORMAT	>> ItemName : %s / Price : %dc / 수량 : %d / 판매기간 : %d월:%d일:%d시:%d분 ~ %d월:%d일:%d시:%d분
MSI_BARGAINSALE_TOOLWND_APPLY_SUCCESS_MSG	등록에 성공하였습니다
MSI_BARGAINSALE_TOOLWND_APPLY_FAILED_MSG	등록에 실패하였습니다. 다시 시도해 주시기 바랍니다.
MSI_BARGAINSALE_TOOLWND_ALREADY_REGISTERED_MSG	이미 등록된 아이템이 있습니다. 다시 시도해 주시기 바랍니다.
MSI_BARGAINSALE_TOOLWND_DELETE_FAILED_MSG	아이템 삭제에 실패 하였습니다. 다시 시도해 주시기 바랍니다.
MSI_BARGAINSALE_TOOLWND_DELETE_SUCCESS_MSG	%s 아이템이 삭제되었습니다.
MSI_BARGAINSALE_CASHSHOP_TAB_NAME	특가
MSI_BARGAINSALE_CASHSHOP_REFRESH_BTN_TOOLTIP	한정판매 아이템 판매수량 갱신
MSI_BARGAINSALE_CASHSHOP_TIMER	판매종료
MSI_BARGAINSALE_CASHSHOP_REFRESH_MSG	수량갱신이 필요합니다
MSI_BARGAINSALE_CASHSHOP_CHECK_COUNT_MSG	재고가 부족하여 %d 개 만큼만 구입합니다
MSI_BARGAINSALE_START_MSG	%s 아이템의 특가판매가 시작되었습니다
MSI_BARGAINSALE_CLOSE_MSG	%s 아이템의 매진 또는 판매시간만료로 인해 한정판매가 종료되었습니다
MSI_BARGAINSALE_TOOLWND_CALL	/한정판매
MSI_FRANCE_CASHSHOP_URL	http://www.ragnarokeurope.com/news/home-r70.html
MSI_FRANCE_CASHSHOP_URL_STEAM	http://www.ragnarokeurope.com/index.php?rubrique=70&Steam
MSI_PARA_RESULT_TITLE	구입에 성공한 품목
MSI_PARA_WRONG_PURCHASE_COUNT_MSG	주문량이 재고량을 초과하였습니다.
MSI_PARTY_INVITE	초대할수 없는 케릭터 이름입니다.
MSI_GUILD_INVITE	길드초대할수  없는 케릭터 이름입니다.
MSI_PARA_PURCHASE_ITEM_FAIL	일부 품목은 이미 판매되어 구입에 실패하였습니다.
MSI_NOWARPSKILL2	현재 위치에서 워프 장소를 기억 할 수 없습니다.
MSI_PARA_PURCHASE_ITEM_WEIGHT	무게가 초과되어 아이템을 구매할 수 없습니다.
MSI_GUILD_STORAGE_NUMBER	No.
MSI_GUILD_STORAGE_ITEM	아이템
MSI_GUILD_STORAGE_ITEM_COUNT	개수
MSI_GUILD_STORAGE_USER_NAME	이름
MSI_GUILD_STORAGE_LOG_TIME	시간
MSI_GUILD_STORAGE_ITEM_IN_OUT	입/출
MSI_GUILD_STORAGE_LOG_FINISH	로그가 존재하지 않습니다.
MSI_GUILD_STORAGE_LOG_ALL	전 체
MSI_GUILD_STORAGE_LOG_IN	넣 기
MSI_GUILD_STORAGE_LOG_OUT	빼 기
MSI_GUILD_STORAGE_LOG_WND_NAME	길드 창고 내역
MSI_GUILD_STORAGE_LOG_CAUTION	내역은 최근 100개만 표시됩니다.
MSI_GUILD_STORAGE_CLOSE_TIMEOUT	길드창고의 사용 시간 2분이 경과되어 자동으로 종료됩니다.
MSI_INCORRECT_GAMESAMBEID	Incorrect GameSamba ID. Please Try Again.
MSI_EA5	%s [%d옵션] : %d 개
MSI_USESKILL_FAIL_COINTS	코인이 필요합니다.
MSI_USESKILL_FAIL_COINTS_NUM	코인이 %d 개가 필요합니다.
MSI_FAIL_NEED_EQUIPPED_GUN_GATLING	개틀링건 계열의 총기류를 장착한 상태여야 합니다.
MSI_FAIL_NEED_EQUIPPED_GUN_SHOTGUN	샷건 계열의 총기류를 장착한 상태여야 합니다.
MSI_FAIL_NEED_EQUIPPED_GUN_RIFLE	라이플 계열의 총기류를 장착한 상태여야 합니다.
MSI_FAIL_NEED_EQUIPPED_GUN_HANDGUN	리볼버 계열의 총기류를 장착한 상태여야 합니다.
MSI_FAIL_NEED_EQUIPPED_PROPERTY_SAINT_BULLET	성속성 블릿을 장착해야 합니다
MSI_MERCHANT_SOLD_ITEM_LOG	아이템 판매 내역
MSI_MERCHANT_ITEM_BUY_LOG	아이템 구매 내역
MSI_FAIL_NEED_EQUIPPED_GUN_GRANADE	그레네이드런쳐 계열의 총기류를 장착한 상태여야 합니다.
MSI_FAIL_DUPLICATE_HEAT_BARREL_GS_MADNESSCANCEL_P_ALTER	[히트배럴],[매드니스 캔슬러],[플래티넘 알터] 의 효과들은 중첩하여 사용할 수 없습니다.
MSI_USESKILL_FAIL_MAP	현재 맵에서는 사용할 수 없는 스킬입니다.
MSI_GUILD_STORAGE_WARNING	길드 창고를 이용중인 경우 창고의 모든 아이템이 사라지게 됩니다.
MSI_AMERICA_CASHSHOP_URL_GAMESAMBA	http://ragnarok.gamesamba.com/paytest.html
MSI_SECOND_PASSWORD_INFO_4	로그인을 위해 패스워드를 입력해주세요.
MSI_PET_EVOLUTION	펫 진화
MSI_PET_EVOLUTION_WITH_PET_NAME	진화 - %s
MSI_PET_EVOLUTION_NEED_ITEM	진화에는 다음의 재료가 필요합니다.
MSI_DO_YOU_WANT_TO_EVOLVE_PET	진화 하시겠습니까?
MSI_PET_EVOLUTION_FAIL_UNKNOWN	알 수 없는 오류
MSI_PET_EVOLUTION_FAIL_NOTEXIST_CALLPET	소환된펫을 갖고 있지 않습니다.
MSI_PET_EVOLUTION_FAIL_NOT_PETEGG	요청한 것이 펫알이 아닙니다.
MSI_PET_EVOLUTION_FAIL_RECIPE	진화 재료가 부족합니다.
MSI_PET_EVOLUTION_FAIL_MATERIAL	진화에 필요한 재료가 부족합니다.
MSI_PET_EVOLUTION_FAIL_RG_FAMILIAR	친밀도가 절친인 상태에서만 진화가 가능합니다.
MSI_PET_AUTO_FEEDING	펫 자동 먹이 주기
MSI_PET_AUTO_FEEDING_REST	펫에게 먹이를 주었습니다. \'%s\' 잔여량 %d개
MSI_PET_AUTO_FEEDING_ON	펫 자동 먹이 주기 활성화 On
MSI_PET_AUTO_FEEDING_OFF	펫 자동 먹이 주기 활성화 Off
MSI_REFRESH	갱신
MSI_TIME_LINE_MINUTE	%d 분 전
MSI_TIME_LINE_HOUR	%d 시간 전
MSI_TIME_LINE_DAY	%d 일 전
MSI_BASIC_EXP_MSG_PH	%d%% ( Premium %d%% + %s Server )
MSI_SEND_MAIL	우편 발송
MSI_MAIL_SENT	메일이 전송되었습니다.
MSI_GET_ITEMS_FROM_MAIL_SUCCEED	아이템이 인벤토리로 이동되었습니다.
MSI_GET_ITEMS_FROM_MAIL_FAILED	아이템 받기가 실패하였습니다.
MSI_GET_ITEMS_FROM_MAIL_OVERWEIGHT	인벤토리를 비워주세요
MSI_GET_ZENY_FROM_MAIL_SUCCEED	제니를 받았습니다.
MSI_GET_ZENY_FROM_MAIL_FAILED	제니 받기가 실패하였습니다.
MSI_GET_ZENY_FROM_MAIL_OVERAMOUNT	제니의 한계치를 넘었습니다.
MSI_SET_ITEMS_TO_MAIL_SUCCEED	아이템 첨부 성공
MSI_INVALID_MAIL_RECIEVER_INFO	받는 사람의 이름이 반드시 들어가야 합니다.
MSI_INVALID_MAIL_TITLE_INFO	제목의 길이는 한글 2자~25자, 영문 4자~50자 이어야 합니다.
MSI_FAILED_SEND_MAIL	메일 전송이 실패하였습니다.
MSI_FAILED_SEND_MAIL_ITEM	적절하지 못한 아이템으로 전송 실패하였습니다.
MSI_FAIELD_SEND_MAIL_TO	받는 사람의 정보가 존재하지 않습니다.
MSI_EA6	%s [%d옵션]
MSI_PARTY_BOOKING_ERR5R2	레벨은 1~%d 사이의 숫자를 입력해 주세요.
MSI_ITEM_WND_OVERFULL	소지창의 여유공간을 확보해주세요.
MSI_FAILED_MAIL_LIMIT_CNT	메일 보내기 횟수가 초과되었습니다.
MSI_FAILED_TO_WRITE_MAIL	메일을 열 수 없습니다.
MSI_JOINED_IN_CLAN	You are currently joined in CLan !!
MSI_GOLDPCCAFE_MILEAGE	골드 PC방 마일리지 정보
MSI_PET_EVOLUTION_FAIL_PET_ACC_OFF	펫 액세서리를 해제해야 진화가 가능합니다.
MSI_TIME_LINE_MINUTE2	%d 분 후
MSI_TIME_LINE_HOUR2	%d 시간 후
MSI_TIME_LINE_DAY2	%d 일 후
MSI_INVALID_CCODE_INFO	확인 버튼을 눌러 C-CODE를 확인하세요.
MSI_FAILED_DELETE_MAIL	첨부된 물품을 획득 후 삭제가 가능합니다.
MSI_FAILED_SEND_MAIL_ZENY	현재 보유 제니 보다 많은 제니를 보낼 수 없습니다.
MSI_SEND_MAIL_COMMISSION	수수료 : %s Zeny
MSI_FAILE_MAIL_RECIEVER_INFO	받는 사람의 이름이 존재하지 않습니다.
MSI_TAIWAN_PERSONALINFO_EXPMSG	E X P : %.1f%% ( basic %.1f%% premium %.1f%% + %s %.1f%%)
MSI_TAIWAN_PERSONALINFO_DROPMSG	DROP  : %.1f%% ( basic %.1f%% premium %.1f%% + %s %.1f%%)
MSI_TAIWAN_PERSONALINFO_DEATHMSG	DEATH : %.1f%% ( basic %.1f%% premium %.1f%% + %s %.1f%%)
MSI_MILEAGE_HELP	골드 PC방 마일리지는 최대 %d점까지 모을 수 있습니다.
MSI_RESTRAINT_OF_TRADE_1	해당 서버에서 사용 할 수 없는 기능 입니다
MSI_RESTRAINT_OF_TRADE_2	수래 이용이 불 가능한 서버 입니다.
MSI_RESTRAINT_OF_TRADE_3	옥션 이용이 불 가능한 서버 입니다.
MSI_RESTRAINT_OF_TRADE_4	거래가 불 가능한 서버 입니다.
MSI_RESTRAINT_OF_TRADE_5	아이템 버리기가 불 가능한 서버 입니다.
MSI_RESTRAINT_OF_TRADE_6	상점 판매 기능을 사용할수 없습니다.
MSI_USESKILL_FAIL_SUMMON_SP_INSUFFICIENT	소환물의 SP가 부족합니다.
MSI_SEND_MAIL_WEIGHT	%s/%s
MSI_INVALID_MAIL_CONTENTS_INFO	메일 내용의 최대 길이는 1K 이하 입니다.
MSI_SET_ITEMS_TO_MAIL_FAILED	아이템 첨부 실패
MSI_SET_ITEMS_TO_MAIL_OVER_WEIGHT	메일에 첨부할수 있는 아이템의 무게가 초과되었습니다.
MSI_DYNAMICNPC_FAIL_DUPLICATENAME	이미 서비스 중입니다. 잠시 후 다시 시도해 주세요.
MSI_FAILED_OPEN_ROULLETTE	행운의 룰렛창을 열 수 없습니다.
MSI_FAILED_CLOSE_ROULLETTE	행운의 룰렛창을 닫을 수 없습니다.
MSI_FAILED_GENERATE_ROULLETTE	행운의 룰렛을 시작 할 수 없습니다.
MSI_NOT_ENOUGH_ROULLETTE_POINT	행운의 룰렛을 시작하기 위해서는 포인트가 필요합니다.
MSI_FAILED_RECV_ITEM	당첨된 아이템을 수령할 수 없습니다.
MSI_FAILED_RECV_ITEM_OVERCOUNT	인벤토리에 아이템 개수가 초과되었습니다.
MSI_FAILED_RECV_ITEM_OVERWEIGHT	무게가 초과하였습니다. 소지창의 여유공간을 확보해주세요.
MSI_MERCHANTSHOP_MAKING_FAIL	노점 개설 실패.
MSI_FAILED_CLOSE_ROULLETTEWND	룰렛이 돌고 있습니다. 경품을 확인 후에 다시 시도해주세요.
MSI_ROULLETTE_WND	행운의 룰렛
MSI_SOUNDEFFECT_ITEMSELLWND	아이템 판매 시 소리로 알림
MSI_FAILED_SEND_MAIL_ITEMS	수수료를 확인해주세요.
MSI_CHECK_USER_NAME	유저이름 확인
MSI_DELETE_DUE_DATE	삭제 예정
MSI_ACHIEVEMENT_SYSTEM	달성과제
MSI_ACHIEVEMENT_TOTAL_SCORE	달성총점
MSI_ACHIEVEMENT_GRADE	달성등급
MSI_ACHIEVEMENT_SCORE_REQUIRED_TO_REWARD	다음 달성등급까지 [%5d]점
MSI_ACHIEVEMENT_SUMMARY_TITLE	진척상황
MSI_ACHIEVEMENT_RECENT_ACHIEVEMENT	최근 달성 업적
MSI_CASH_GEDARE1	仙貝 품목
MSI_CASH_GEDARE2	仙貝 : %d / %d 
MSI_CASH_GEDARE_FAIL_MONEY	仙貝가 부족합니다.
MSI_CASH_GEDARE_MONEY	%s 
MSI_ACHIEVEMENT_TAB_SUMMARY	개요
MSI_ACHIEVEMENT_TAB_GENERAL	일반
MSI_ACHIEVEMENT_TAB_GENERAL_CHARACTER	캐릭터
MSI_ACHIEVEMENT_TAB_GENERAL_ACTION	행동
MSI_ACHIEVEMENT_TAB_GENERAL_REST	기타
MSI_ACHIEVEMENT_TAB_ADVENTURE	모험
MSI_ACHIEVEMENT_TAB_ADVENTURE_RUNEMIDGARTS	룬미드가츠
MSI_ACHIEVEMENT_TAB_ADVENTURE_SCHWARZWALD	슈발츠발드
MSI_ACHIEVEMENT_TAB_ADVENTURE_ARUNAFELTZ	아루나펠츠
MSI_ACHIEVEMENT_TAB_ADVENTURE_ANOTHERWORLD	이계
MSI_ACHIEVEMENT_TAB_ADVENTURE_LOCALIZING	로컬라이징
MSI_ACHIEVEMENT_TAB_ADVENTURE_DUNGEON	던전
MSI_ACHIEVEMENT_TAB_BATTLE	전투
MSI_ACHIEVEMENT_TAB_BATTLE_PVP	결투
MSI_ACHIEVEMENT_TAB_BATTLE_TRAINING	수련
MSI_ACHIEVEMENT_TAB_QUEST	퀘스트
MSI_ACHIEVEMENT_TAB_QUEST_EPISODE	에피소드
MSI_ACHIEVEMENT_TAB_QUEST_GENERAL	일반
MSI_ACHIEVEMENT_TAB_MEMORIAL	메모리얼
MSI_ACHIEVEMENT_TAB_MEMORIAL_MIDGARD	미드가르드
MSI_ACHIEVEMENT_TAB_MEMORIAL_ANOTHERWORLD	이계
MSI_ACHIEVEMENT_TAB_MEMORIAL_REST	기타
MSI_ACHIEVEMENT_TAB_ACHIEVEMENT	위업
MSI_ACHIEVEMENT_TAB_TOTAL	달성한 과제
MSI_FAIL_ADD_ACHIEVEMENT_TRACING	더 이상 추가할 수 없습니다.
MSI_NOTICE_COMPLETE_ACHIEVEMENT	< %s > 달성하였습니다.
MSI_OTPUSER_ONLY	only otp user login allow
MSI_GET_ROULLETE_PRIZE	이 버튼을 누를 시, 지정된 상품을 받게되며 룰렛은 초기화 됩니다.
MSI_NOTICE_NEXT_ROULLETE_STAGE	이 버튼을 누를 시, 깜빡이는 화살표의 라인부터 룰렛을 시작 합니다.
MSI_TITLE_EQUIPMENT	칭호
MSI_TAKEOFF_TITLE	칭호 해제
MSI_GUILD_MAKE_GUILD_NOT_PERMITTED_MAP	길드 생성을 할 수 없는 지역입니다.
MSI_GUILD_DISORGANIZE_GUILD_NOT_PERMITTED_MAP	길드 해체를 할 수 없는 지역입니다.
MSI_GUILD_JOIN_GUILD_NOT_PERMITTED_MAP	길드 가입을 할 수 없는 지역입니다.
MSI_GUILD_LEAVE_GUILD_NOT_PERMITTED_MAP	길드 탈퇴를 할 수 없는 지역입니다.
MSI_GUILD_EXPEL_GUILD_NOT_PERMITTED_MAP	길드원 추방을 할 수 없는 지역입니다.
MSI_GUILD_POSITION_CHANGE_NOT_PERMITTED_MAP	길드직위 변경을 할 수 없는 지역입니다.
MSI_NOT_ENOUGH_SPACE_IN_ITEM_BODY	아이템 소지량을 5칸이상 비워주세요
MSI_JPN_PERSONALINFO_EXPMSG	E X P : %.1f%% ( basic 100.0%% pccafe %.1f%% + %s %.1f%%)
MSI_JPN_PERSONALINFO_DROPMSG	DROP  : %.1f%% ( basic 100.0%% pccafe %.1f%% + %s %.1f%%)
MSI_JPN_PERSONALINFO_DEATHMSG	DEATH : %.1f%% ( basic 100.0%% pccafe %.1f%% + %s %.1f%%)
MSI_SET_ITEMS_TO_MAIL_OVERCOUNT	첨부할 수 있는 아이템의 갯수가 초과되었습니다.
MSI_SOUNDEFFECT_ITEMBUYWND	아이템 구매 시 소리로 알림
MSI_SET_UNMOVEABLE_ITEM	첨부할 수 없는 아이템입니다.
MSI_RESULT_ALREADY_LOSING_IDX	꽝에 당첨되었으므로 다음 상위 단계의 룰렛을 돌리실 수 없습니다.
MSI_RODEX_FOWARD	답장쓰기
MSI_RODEX_READ	내용읽기
MSI_RODEX_DELETE	메일삭제
MSI_TAIWAN_CASH_MSG_1	仙貝 : %d
MSI_TAIWAN_CASH_MSG_2	%s %s 仙貝
MSI_TAIWAN_CASH_MSG_3	仙貝
MSI_TAIWAN_CASH_MSG_4	Total : %d 仙貝
MSI_TAIWAN_CASH_MSG_5	%d -> %s 仙貝
MSI_TAIWAN_CASH_MSG_6	%s 仙貝
MSI_TAIWAN_CASH_MSG_7	                                          Current 仙貝 : %s
MSI_TAIWAN_CASH_MSG_8	    %s  :  %s  仙貝
MSI_TAIWAN_CASH_MSG_9	%10s 仙貝
MSI_TAIWAN_CASH_MSG_10	Total : %s 仙貝
MSI_TAIWAN_CASH_MSG_11	※수수료 3% / 최소 1仙貝의 수수료 차감 
MSI_TAIWAN_CASH_ITEM_BAY_MAG2	仙貝 입니다.
MSI_TAIWAN_CASH_WARNING_PRICE6	^0000ff仙貝 이상^000000입니다.\n입력금액이 맞습니까?
MSI_TAIWAN_CASH_WARNING_PRICE7	10억仙貝이상 안전 확인
MSI_TAIWAN_CASH_OVERPRICE_MAX	10억 仙貝 이상 입력하셔도 가격은 10억 仙貝로 판매됩니다.
MSI_TAIWAN_CASH_OVERPRICE9999	9,999仙貝 이상 입력하셔도 가격은 9,999仙貝로 판매됩니다.
MSI_TAIWAN_CASH_YOU_HAVE_FREE_ITEM_ON_SHOP	가격이 0 仙貝인 아이템이 존재 합니다. 상점을 열수 없습니다!
MSI_TAIWAN_CASH_MCSTORE_FAIL_SELLER_MONEY_GIVE	상대 캐릭터가 최대 보유 仙貝량을 초과하여 거래가 불가능 합니다.
MSI_TAIWAN_CASH_BUYINGSTORE_MAKEWND_REINPUTPRICE	%s 아이템의 가격을 10억仙貝 이하로 입력해 주세요.
MSI_TAIWAN_CASH_BUYINGSTORE_MAKEWND_ITEMLIST	%s  :  %s  仙貝 => %s EA
MSI_TAIWAN_CASH_BUYINGSTORE_MYSHOPWND_LIMITZENY	제한 금액 : %s 仙貝
MSI_TAIWAN_CASH_BUYINGSTORE_MYSHOPWND_ITEMINFO	%s %s 仙貝 %d 개
MSI_TAIWAN_CASH_BUYINGSTORE_TRADE_SELLCOMPLETE	%s %d개를 %d 仙貝에 판매 하였습니다. 수수료는 3%% 입니다.
MSI_RODEX_WND	RODEX
MSI_RODEX_SEND_WND	SEND
MSI_RODEX_RECEIVE_WND	RECEIVE
MSI_RODEX_CHOOSEWND_FAILED	메일 작성창을 닫아주세요.
MSI_ACCESS_DENIED_BY_AUTHSERVER_CONNECTION	서버접근거부(A)
MSI_ACCESS_DENIED_BY_BILLSERVER_CONNECTION	서버접근거부(B)
MSI_UNEQUIP_ARROW2	장착된 화살/탄환 을 해제해야합니다.
MSI_FAILED_MAIL_CAUSE_TO_USE_ITEM	인벤토리의 아이템이 소모되어 로덱스 쓰기창을 닫습니다.
MSI_FAILIED_ONECLICK_ITEMIDENTIFY_NO_MAGNIFIER	소지하신 돋보기가 없습니다.
MSI_FAILED_UNLOCK_ITEM_DROP_IN_COMPOSE_WND	아이템을 버릴려면 메일 쓰기창을 닫아주세요.
MSI_FAILED_FRIEND_ADD__ALREADY_REQUEST	상대방이 친구 요청중입니다
MSI_UISCRIPT_ERROR_GUIDE	SCRIPT ERROR AID
MSI_UISCRIPT_ERROR_GUIDE_MSG	\nErrorfile : %s\nErrorLine : %d 줄\nErrorContent: \n*이전 줄 : %s \n*Errorline : %s \n*다음 줄:\n %s
MSI_TAIWAN_CASH_BUY_RECONFIRM	 ^ff0000해당 아이템을 구매 하시겠습니까? %d포인트 및 %d 仙貝가 차감 됩니다.
MSI_MINIMAP_MSG_01	닫기
MSI_MINIMAP_MSG_02	퀘스트
MSI_MINIMAP_MSG_03	퀘스트 아이콘 보기
MSI_MINIMAP_MSG_04	편의시설
MSI_MINIMAP_MSG_05	편의시설 아이콘 보기
MSI_MINIMAP_MSG_06	길드원/파티원
MSI_MINIMAP_MSG_07	길드원/파티원 보기
MSI_MINIMAP_MSG_08	기록하기
MSI_MINIMAP_MSG_09	보스몬스터
MSI_MINIMAP_MSG_10	나
MSI_MINIMAP_MSG_11	삭제 하시겠습니까?
MSI_MINIMAP_MSG_12	퀘스트 NPC
MSI_MINIMAP_MSG_13	메모할 내용을 기록합니다
MSI_MINIMAP_MSG_14	저장하기
MSI_MINIMAP_MSG_15	메모하기
MSI_EA7	%s [%d옵션] %d개
MSI_EA8	%s [%d옵션] %s Zeny
MSI_EA9	%s [%d옵션] %d %s %d -> %s %s
MSI_EA10	%s [%d옵션] %d %s %s %s
MSI_EA11	%s [%d옵션] %d -> %s %s
MSI_EA12	%s [%d옵션] %s %s
MSI_TAIWAN_CASH_LEMITEMIN	최소 거래 단위 100 仙貝 이상으로 설정 하셔야 합니다.
MSI_DRESSROOM_HEARCOLOR	머리 색
MSI_DRESSROOM_HEARSTYLE	머리 모양
MSI_DRESSROOM_BODYCOLOR	옷 색
MSI_DRESSROOM_BODYSTYLE	옷 모양
MSI_MINIMAP_MSG_16	지원되지 않는 맵 입니다.
MSI_BANK_MAX_MONEY	2,147,483,647 Zeny 이하로 입력 하십시오.
MSI_BANK_MIN_MONEY	1 Zeny 이상 입력 하십시오.
MSI_BANK_0_MONEY	보유한 Zeny 가 없습니다.
MSI_BANK_1	제니 창고
MSI_BANK_2	창고보유액
MSI_BANK_3	소지금
MSI_BANK_4	입금
MSI_BANK_5	출금
MSI_BANK_6	1 z UP
MSI_BANK_7	1 z Down
MSI_BANK_MAX	Max
MSI_BANK_NOMSG	입력값이 없습니다
MSI_BANK_0_MINI	보유 Zeny 부족
MSI_BANK_1_MINI	입력값 필요
MSI_BANK_2_MINI	문자 입력 불가
MSI_BANK_3_MINI	최대 입력 초과
MSI_BANK_4_MINI	최소 입력 미만
MSI_BANK_5_MINI	보유 Zeny 부족
MSI_BANK_6_MINI	은행 잔고 부족
MSI_BANK_7_MINI	최대 보유 Zeny 초과
MSI_ITEMMOVEINFO_DROP	드롭 X
MSI_ITEMMOVEINFO_STORE	창고 X
MSI_ITEMMOVEINFO_CART	카트 X
MSI_ITEMMOVEINFO_MAIL	메일 X
MSI_ITEMMOVEINFO_EXCHANGEWND	교환창 X
MSI_ITEMMOVEINFO_AUCTION	경매장 X
MSI_ITEMMOVEINFO_STOREOFGUILD	길드창고 X
MSI_ITEMMOVEINFO_TONPC	NPC에게 판매 X
MSI_ITEMMOVEINFO_BTN	이동제한이 있는 아이템입니다.
MSI_CREATE_CHARACTER	캐릭터를 생성해주세요!
MSI_UNEQUIP_ARROW3	장착된 투사체 아이템을 해제해야 합니다.
MSI_REFUSE_MDENGEON_IS_FULL	인원 초과로 메모리얼 던전에 입장 할 수 없습니다
MSI_ERROR_MDENGEON_IS_FULL	인원수 초과로 인해  메모리얼 던전 입장이 거부되었습니다
MSI_INFORMATION_USA	%.1f%% ( %s Server: %.1f%% + Premium:%.1f%% )
MSI_INFORMATION_USA_DEATH	%.1f%% ( %s Server: %.1f%% + Premium:%.1f%% )
MSI_PERVENT_DUPLICATEUSE_ITEM	중복된 아이템이 존재하여 사용이 불가능 합니다.
MSI_PERVENT_DUPLICATEUSE_EFSTITEM	중복된 효과가 존재하여 사용이 불가능 합니다.
MSI_QUAKE_EFFECT_ON	화면 흔들림 효과 ON
MSI_QUAKE_EFFECT_OFF	화면 흔들림 효과 OFF
MSI_GAMEHACK_DETECT2	불법 프로그램  발견되었습니다
MSI_SEND_RODEX	메일 보내기
MSI_USA_PERSONALINFO_EXP	E X P : %.1f%% ( basic 100.0%% VIP Bonus %.1f%% + %s %.1f%%)
MSI_USA_PERSONALINFO_DROP	DROP  : %.1f%% ( basic 100.0%% VIP Bonus %.1f%% + %s %.1f%%)
MSI_USA_PERSONALINFO_DEATH	DEATH : %.1f%% ( basic 100.0%% VIP Bonus %.1f%% + %s %.1f%%)
MSI_NOT_USING_TAG_TO_NAME	 해당 내용은 이름으로 사용하실 수 없습니다. 
MSI_STYLING_SHOP	스타일링 샾
MSI_STYLING_SHOP_NEED_COUPON	쿠폰 없음. Cash Shop에서 아이템을 구매해 주세요.
MSI_STYLING_SHOP_OPEN_COUPON	인벤토리에서 아이템 쿠폰 상자를 열어주세요.
MSI_STYLING_SHOP_DELETE_CHAR	해당 스타일 정보를 삭제하시겠습니까?
MSI_STYLING_SHOP_FAIL_TO_ADD_CHAR_TO_LIKE	슬롯이 꽉 찼습니다. 내 스타일에서 캐릭터 삭제 후 사용해 주십시오.
MSI_STYLING_SHOP_ADJUST_NEW_CHAR_STYLE	비용을 지불하고 현재 스타일을 적용하시겠습니까?\n(※ 비용은 반환되지 않습니다.)
MSI_STYLING_SHOP_REGISTER_BOOKMARK	현재 스타일을 저장하였습니다.
MSI_STYLING_SHOP_SUGGEST_TO_GO_TO_BANK	보유 Zeny 부족. 은행에 충분한 Zeny가 있습니다.
MSI_ASK_MOVE_BY_PRIVATE_AIRPLANE	으로 이동합니다.
MSI_PRIVATE_AIRPLANE_FAIL_LOCALIZING	해당 국가의 영공통과에 대한 허가가 나지 않았습니다.
MSI_PRIVATE_AIRPLANE_FAIL_OTHERWORLD	마나로 대기불안정이 계속되어 비공정 운행이 불가능합니다.
MSI_PRIVATE_AIRPLANE	개인 비공정
MSI_PRIVATE_AIRPLANE_FAIL_UNKNOWN	잠시 후 다시 시도해주세요.
MSI_PRIVATE_AIRPLANE_FAIL_PAYMENT_ZENY	개인 비공정 이용에 필요한 제니가 부족합니다.
MSI_PRIVATE_AIRPLANE_FAIL_PAYMENT_ITEM	개인 비공정 이용에 필요한 아이템이 부족합니다.
MSI_PRIVATE_AIRPLANE_FAIL_LEVEL	개인 비공정을 이용할 수 있는 레벨이 아닙니다.
MSI_PRIVATE_AIRPLANE_FAIL_MAP	선택한 지점으론 개인비공정이 이동할 수 없습니다.
MSI_RESULT_FAIL_USING_MAP	현 지점에선 개인비공정을 이용할 수 없습니다.
MSI_STYLING_SHOP_ACCESSORYWND	액세서리
MSI_STYLING_SHOP_2NDCOSTUMEWND	세컨드코스튬
MSI_STYLING_SHOP_LIKELISTWND	내 스타일 
MSI_STYLING_SHOP_IS_NOT_COLORING_HEAD	염색할 수 없는 헤어스타일입니다.
MSI_STYLING_SHOP_OPENING_COMMENT	화살표를 눌러 마음에 드는 스타일을 선택해 보세요.
MSI_STYLING_SHOP_SUCCESS	새로운 스타일을 확인해 보세요.\n(※ 액세서리 구매 시 RODEX로 발송됩니다.)
MSI_STYLING_SHOP_BASICSTYLE	기본 스타일
MSI_UPGRADESKILLERROR_MORE_BASE_LEVEL	 해당 스킬은 BaseLv %d 이상부터 스킬 포인트 투자가 가능합니다.
MSI_NOT_USING_SPECIALLETTERS_ON_PARTYNAME	해당 특수기호는 이름에 사용하실 수 없습니다.
MSI_SKILL_FAIL_MHP_TOO_FEW	MHP가 너무 낮아, 해당 스킬을 사용할 수 없습니다
MSI_SKILL_FAIL_MSP_TOO_FEW	MSP가 너무 낮아, 해당 스킬을 사용할 수 없습니다
MSI_INVENTORY_ITEM_COMPARE	아이템 비교하기
MSI_INVENTORY_ITEM_DROP_LOCK	아이템 버리기 잠금
MSI_NOT_ADDING_SCREENSHOT	스크린샷 파일이 첨부 되지 않았습니다.
MSI_CONNECT_SNS_WND	Twitter
MSI_RODEX_GENERAL	일반
MSI_RODEX_NOTICE	공지
MSI_RODEX_RETURN	반송
MSI_RODEX_REFRESH	새로고침
MSI_RODEX_DELETE_TIME_MINUTE	%d분
MSI_RODEX_DELETE_TIME_HOUR	%d시간
MSI_RODEX_DELETE_TIME_DAY	%d일
MSI_RODEX_RETURNED	반송됨
MSI_RODEX_DELETE_SELECT_MAIL	선택한 메일을 삭제하시겠습니까?
MSI_MINIMAP_TIP_POS_ON	위치표시
MSI_MINIMAP_TIP_ZOOM_IN	확대
MSI_MINIMAP_TIP_ZOOM_OUT	축소
MSI_MINIMAP_TIP_MAP_VIEW	맵보기
MSI_MINIMAP_TIP_WORLD_VIEW	월드보기
MSI_INVENTORY_NUMBER_OF_ITEM	아이템 소지 종류수
MSI_MINIMAP_BUTTON_ONOFF	/minimap
MSI_MINIMAP_BUTTON_ON	미니맵 버튼을 표시합니다
MSI_MINIMAP_BUTTON_OFF	미니맵 버튼을 표시하지 않습니다
MSI_GUILD_MEMBERLIST_SORT	길드 접속자 정렬
MSI_WRITE_PET_RELATION_SHIP	친밀도 : %s
MSI_PET_RELATION_SHIP_UNKNOWN	확인 전
MSI_PARTYNAME	파티 이름
MSI_PARTYMASTER	파티장
MSI_MACRO_DETECTOR_TIME_OVER	제한 시간 초과. 클라이언트를 종료합니다.
MSI_MACRO_DETECTOR_WRONG_ANSWER	잘못된 입력입니다. 클라이언트를 종료합니다.
MSI_MACRO_DETECTOR_CORRECT_ANSWER	정답 입니다. 보상으로 소정의 버프가 주어집니다.
MSI_MACRO_INPUT_ANSWER	영문 4자, 한글 2자 이상으로 입력해야 합니다.
MSI_MACRO_CHECK_ANSWER	입력한 답이 [%s]가 맞습니까?
MSI_MACRO_SELECT_CAPTCHA	선택된 이미지가 없습니다.
MSI_MACRO_DETECTOR_WRONG_ANSWER_REMAIN_CNT	잘못된 입력입니다. (남은 기회 %d번)
MSI_MACRO_REPORTER	총 %d명의 유저를 신고하시겠습니까?
MSI_MACRO_SEND_MACRO	유저에게 메시지를 보냈습니다.
MSI_MACRO_REGISTER_DATA	불법 프로그램 단속에 필요한 데이터가 미등록 상태입니다.
MSI_MACRO_ALREADY_DETECTING	이미 매크로 감시중인 유저입니다.
MSI_MACRO_COMPLETE_REGISTER_CAPTCHA	매크로가 등록되었습니다..
MSI_MACRO_FAILED_REGISTER_CAPTCHA	이미지 등록에 실패하였습니다.
MSI_MACRO_FAILED_REGISTER_ANSWER	정답 등록에 실패하였습니다.
MSI_MACRO_DETECTOR_NOTICE1	안녕하세요. 불법프로그램 단속중입니다.
MSI_MACRO_DETECTOR_NOTICE2	지정된 시간내에 아래의 문자를 입력해주세요.
MSI_MACRO_DETECTOR_NOTICE3	6회 오류시 운영정책에 의거하여 제재됩니다.
MSI_MACRO_DETECTOR_REMAIN_COUNT	남은 횟수 : %d
MSI_MACRO_REPORTER_SELECT_MODE_CHAR	캐릭터
MSI_MACRO_REPORTER_SELECT_MODE_CELL	범위
MSI_MACRO_REPORTER_TOOLTIP_CHAR	캐릭터 선택은 좌클릭으로 합니다.
MSI_MACRO_REPORTER_TOOLTIP_CELL	범위 선택은 우클릭으로 합니다.
MSI_MACRO_REPORTER_TOOLTIP_RANGE	범위 크기를 지정하기 위해서는 엔터를 입력해주세요
MSI_TAIWANSS_PERSONALINFO_EXPMSG	E X P : %.1f%% ( basic %.1f%% %s %.1f%%)
MSI_TAIWANSS_PERSONALINFO_DROPMSG	DROP  : %.1f%% ( basic %.1f%% %s %.1f%%)
MSI_TAIWANSS_PERSONALINFO_DEATHMSG	DEATH : %.1f%% ( basic %.1f%% %s %.1f%%)
MSI_WRITE_RODEX_DIFFERENT_RECEIVER_NAME	변경된 캐릭명으로 발송했습니다. 변경된 캐릭명 : %s 
MSI_LAPINE_INGREDIENT_TO_COMBINE	합성에 필요한 재료
MSI_LAPINE_FAIL_NOT_ENOUGH_ITEM	조합 재료가 부족해서 조합할 수 없습니다.
MSI_LAPINE_FAIL_NOT_ENOUGH_ITEM_COUNT	해당 재료는 %d개가 필요합니다.
MSI_LAPINE_FAIL_NOT_ENOUGH_REFINING_LEVEL	제련도가 낮아서 조합할 수 없습니다.
MSI_REGISTER_PARTY_TO_BOOKINGSYSTEM	모험가중개소에 등록 하시겠습니까?
MSI_INPUT_FREE_MESSAGE	자유롭게 코멘트를 남겨보세요.
MSI_CAPTCHA_INPUT_ANSWER	그림에 보이는 문자를 입력해주세요.
MSI_CAPTCHA_REMAIN_TIME	%d초 남았습니다
MSI_GOOGLE_OTP_INPUT_CODE	OTP 인증번호 6자리를 입력해 주세요
MSI_GOOGLE_OTP_AUTH_CODE	인증번호
MSI_GOOGLE_OTP_MSG	6자리의 숫자가 아닙니다. 다시 확인해 주세요
MSI_RODEX_DELETED_MAIL	이미 삭제된 메일입니다.
MSI_SELECT_AREA_BY_PRIVATE_AIRPLANE	개인 비공정으로 이동할 지역을 선택해주세요.
MSI_THAI_PERSONALINFO_EXP	E X P : %d%% ( basic 100.0%% %s %d%%)
MSI_THAI_PERSONALINFO_DROP	DROP  : %d%% ( basic 100.0%% %s %d%%)
MSI_THAI_PERSONALINFO_DEATH	DEATH : %d%% ( basic 100.0%% %s %d%%)
MSI_FLOATING_PRIVATE_AIRPLANE	목적지로 이동중입니다.
MSI_NOT_FOUND_USER_AI	[%s] 파일이 존재하지 않아 default AI 로 동작합니다
MSI_BASIC_EXP_MSG_BRZ2	 %.1f%% ( Basic 100.0%% + Premium %.1f%% + %s %.1f%%)
MSI_ASSISTANT_VENDING_POS	이 자리에 노점을 세우시겠습니까?
MSI_DORAM_CANT_EQUIT_THIS	도람족은 해당 의상을 입을 수 없습니다.
MSI_SEND_PURCHASES_BY_RODEX	판매 노점에서 거래한 아이템이 로덱스로 배송되었습니다.
MSI_BUTTON_PAY_BY_ZENY	30,000 z
MSI_BUTTON_PAY_BY_CAN	말랑도 특산 통조림 100개
MSI_CANNOT_ACCESS_BY_WEIGHTOVER_80	무게가 80%를 초과하여 진행할 수 없습니다.
MSI_SEND_REST_ITEMS_BY_RODEX	판매되지 못한 상품이 로덱스로 배송되었습니다.
MSI_BUTTON_EQUIP_PREVIEW	장착 모습
MSI_CHANGE_GUILD_MASTER	길드마스터 위임
MSI_CONFIRM_CHANGING_GUILD_MASTER	정말로 %s님께 길드마스터를 위임하시겠습니까? 위임 후 당신의 지위는 %s님과 지위가 바뀌게 됩니다.
MSI_WITHDRAWAL	철회
MSI_SHOP_WITHDRAWAL	노점을 철수하시겠습니까?
MSI_REMAIN_TIME	%02d일 %02d시간 %02d분 %02d초
MSI_LIMIT_USER	접속불가
MSI_LIMIT_USER_MSG	접속가능인원을 초과하여 접속이 불가능 합니다.
MSI_SELECT_SHOP_POSITION	노점을 설치할 위치를 선택해주세요.
MSI_CHANGE_PETNAME	펫 이름을 ^0000ff^0000ff %s^000000^000000 로 수정합니다. 계속 하시겠습니까?
MSI_STORE_ASSISTANT_TRADE_DATE	거래 일시 : 
MSI_STORE_ASSISTANT_TRADE_ITEM	거래 아이템 : 
MSI_STORE_ASSISTANT_TRADE_CNT	거래 수량 : 
MSI_STORE_ASSISTANT_TRADE_PRICE	거래 단가 : 
MSI_STORE_ASSISTANT_TRADE_PAYMENT	거래 금액 : 
MSI_STORE_ASSISTANT_TRADE_TITLE1	노점 판매 아이템
MSI_STORE_ASSISTANT_TRADE_TITLE2	노점 구매 아이템
MSI_STORE_ASSISTANT_TRADE_TITLE3	판매 노점 아르바이트 종료
MSI_STORE_ASSISTANT_TRADE_TITLE4	구매 노점 아르바이트 종료
MSI_STORE_ASSISTANT_TRADE_REST_ZENY	남은 금액:
MSI_STORE_ASSISTANT_TRADE_REST_ITEM	아이템 리스트:
MSI_STORE_ASSISTANT_EMPLOYMENT	노점 아르바이트생
MSI_STORE_ASSISTANT_RETURN_ITEM	반환 아이템:
MSI_STORE_ASSISTANT_RETURN_CNT	반환 수량:
MSI_STORE_ASSISTANT_REUTRN_DATE	반환 일시:
MSI_STORE_ASSISTANT_SEND_SELLS_BY_RODEX	구매 노점에서 거래한 금액이 로덱스로 배송되었습니다
MSI_CANNOT_USE_NAME	사용할 수 없는 이름입니다.
MSI_STYLING_SHOP_ARRIVE_GOODS	상품이 도착했습니다.
MSI_STYLING_SHOP_THANK_YOU	구입해주셔서 감사합니다.
MSI_CANNOT_SELL_IN_PRIVATE_TAB	NPC에게 아이템을 판매하지 않습니다.
MSI_LOCK_SELL_IN_PRIVATE_TAB	아이템 판매 잠금
MSI_NOTFOUND_CALLPOSITION	근처에서 소환가능 위치를 찾을수 없습니다.
MSI_CONNECT_SNS_WHOLE_SCREEN_SHOT	전체 화면 캡쳐
MSI_CONNECT_SNS_PART_SCREEN_SHOT	부분 화면 캡쳐
MSI_CONNECT_SNS_SEND	보내기
MSI_BABY_INDEPENDENCE_RODEX_SENDER	가족 분과 담당자
MSI_BABY_INDEPENDENCE_RODEX_TITLE	가족 사항 변동 안내
MSI_BABY_INDEPENDENCE_RODEX_CONTENTS	안녕하십니까.\r\n\r\n금일 \"%s\"님과 \"%s\"님의 자녀인 \"%s\"님이 독립하여 단독 세대를 구성하였습니다.\r\n\r\n이에 서면으로 안내를 드립니다.\r\n\r\n가족 관계 확인을 원하시는 분은 프론테라 동사무소의 담당 직원에게 문의하시기 바랍니다.\r\n\r\n감사합니다.
MSI_EQUIPMENT	장착
MSI_CONNECT_SNS_DO_NOT_EXIST_IMAGE	이미지 없음
MSI_BLOCK_CALL	[%s]은(는) 현재 호출을 차단한 상태입니다.
MSI_IMPOSSIBLE_CHANGE_GUILD_MASTER_IN_SIEGE_TIME	현재 공성전이 진행중이므로, 길드마스터를 위임 할 수 없습니다.
MSI_IMPOSSIBLE_CHANGE_GUILD_MASTER_NOT_TIME	현재 길드장 위임을 받은지 만 하루가 지나지 않아, 길드장을 위임할 수 없습니다.
MSI_SUGGEST_BABY3	아이가 되면 전승을 할 수 없고 스텟의 제한이 있으며 HP와 SP가 줄어듭니다.\n그래도 괜찮습니까?
MSI_REFINING	제련
MSI_USING_BLACKSMITH_BLESSING	대장장이의 축복을 사용중입니다.
MSI_NOTENOUGH_ZENY	제니가 부족합니다.
MSI_NOTENOUGH_BLACKSMITH_BLESSING	대장장이의 축복 개수가 부족합니다.
MSI_CANNOT_REFINE_ITEM	해당 장비는 제련이 불가능합니다.
MSI_REFINING_SUCCESS	제련 성공
MSI_REFINING_FAIL	제련 실패
MSI_RETURN	돌아가기
MSI_SUCCESS	성공
MSI_RESET	원래대로
MSI_MANUFACTURED_MARRIAGERING_ITEM	씨와의 
MSI_CHANGE_HOMUN_NAME	호문클루스의 이름을 ^0000ff^0000ff %s^000000^000000 로 수정합니다. 계속 하시겠습니까?
MSI_BLOCK_CALL_PERMIT	호출이 허용된 상태입니다. (호출 기능 ON)
MSI_BLOCK_CALL_REJECT	호출이 차단된 상태입니다. (호출 기능 OFF)
MSI_BLOCK_CALL_NOTIFY	호출 메시지 표시
MSI_RESULT_FAIL_ASSISTANT	해당 캐릭터가 현재 노점 아이템을 사용 중이므로 삭제할 수 없습니다.
MSI_USESKILL_FAIL_EXIST_STORE_ASSISTANT	이미 동일한 노점 NPC가 설치 중입니다.
MSI_RESULT_FAILED_ASSISTANT_POS	노점을 설치할 수 없는 위치입니다.
MSI_RESULT_FAILED_ASSISTANT_POS_CHARACTER	다른 캐릭터가 있는 위치에는 노점을 설치할 수 없습니다.
MSI_FAILED_PET_AUTO_FEEDING_CLOSE_RODEX	펫 먹이주기가 실패했습니다. 로덱스 작성창을 닫아주세요.
MSI_SWAP_EQUIPITEM_EQUIPMENTSET	장비 세트 설정
MSI_SWAP_EQUIPITEM_EQUIP	장착 하기
MSI_REFINING_FAIL_ITEM_DISAPPEAR	제련 실패시 장비가 사라집니다.
MSI_REFINING_FAIL_ITEM_DOWMGRADE	제련 실패시 장비의 제련도가 내려갑니다.
MSI_REFINING_FAIL_ITEM_DISAPPEAR_OR_ITEM_DOWNGRADE	제련 실패시 장비의 제련도가 내려가거나 사라질 수 있습니다.
MSI_CLOSE_RODEX_FOR_REFINING	제련 중에는 로덱스를 사용할 수 없습니다. 로덱스를 강제 종료하였습니다.
MSI_CANNOT_OPEN_RODEX_DURING_REFINING	제련 중에는 로덱스를 사용할 수 없습니다.
MSI_REFINING_FAIL_CLOSE_UI	제련을 진행하려면 다른 창을 닫아주세요.
MSI_AURA_EFFECT_ON	오오라가 정상적으로 표시됩니다 [오오라 ON]
MSI_AURA_EFFECT_OFF	오오라가 표시되지 않습니다 [오오라 OFF]
MSI_ALREADY_AURA_EFFECT_OFF	오오라가 Off 상태입니다. Off 를 해제하고 시도해 주세요
MSI_USESKILL_FAIL_NEED_MORE_BULLET_CNT	스킬 발동시 최소 %d개의 탄알이 필요합니다.
MSI_SWAP_EQUIPITEM_DO_SWAP	장비 세트를 변경하시겠습니까?
MSI_SWAP_EQUIPITEM_FAIL_DEAD	죽은 상태에서는 할 수 없습니다
MSI_SWAP_EQUIPITEM_FAIL_CASTING	캐스팅 도중에는 할 수 없습니다
MSI_SWAP_EQUIPITEM_FAIL_DEAL	거래 도중에는 할 수 없습니다
MSI_SWAP_EQUIPITEM_FAIL_MERCHANTSHOP	노점 개설 도중에는 할 수 없습니다
MSI_SWAP_EQUIPITEM_FAIL_USE_NPC	NPC 이용중에는 할 수 없습니다
MSI_SWAP_EQUIPITEM_FAIL_CHAT	채팅방 이용중에는 할 수 없습니다
MSI_MDUNGEON_CREATE_FAIL_PARTY_ONLINE	파티원 전원이 접속 상태가 아닙니다.
MSI_USESKILL_FAIL_NEED_MORE_ARROW_CNT	스킬 발동시 최소 %d개의 화살이 필요합니다.
MSI_SORT_ITEM	아이템 정렬
MSI_SWAP_EQUIPITEM_CLOSE_WND	아이템을 버리려면 장비 설정 창을 닫아주세요.
MSI_SWAP_EQUIPITEM_FAIL_NO_ITEM	교체 할 수 있는 아이템이 없습니다.
MSI_BABY_INDEPENDENCE_RODEX_ERASED	삭제된 캐릭터
MSI_TIME_TYPE4	%Y.%m.%d
MSI_LAST_LOGIN	접속일: %s
MSI_CLOSE_BANKING_FOR_REFINING	제련 중에는 은행을 사용할 수 없습니다. 은행을 강제 종료하였습니다.
MSI_CANNOT_OPEN_BANKING_DURING_REFINING	제련 중에는 은행을 사용할 수 없습니다.
MSI_SWAP_EQUIPITEM_UNREGISTER_FIRST	장비 세트 설정 중인 아이템입니다.
MSI_NEWMAKECHAR_HUMAN	인간
MSI_NEWMAKECHAR_HUMANJOB	검사, 법사, 상인, 복사, 도둑, 궁수
MSI_NEWMAKECHAR_DORAM	도람
MSI_NEWMAKECHAR_DORAMJOB	소환사
MSI_NEWMAKECHAR_HUMANINFO	미드가르드 대륙의 대표 종족. 무한한 잠재력과 뛰어난 적응력으로 문제 해결에 탁월한 것이 특징이다.
MSI_NEWMAKECHAR_DORAMINFO	파-스타 대륙의 대표적인 종족 중 하나로, 선천적으로 호기심이 강하고 발랄한 성격을 지녔다.
MSI_PICKUP_FAILED_ITEMCREATE	소지 한계량이 70%를 초과하거나, 인벤토리에 10칸 이상의 여유 공간이 부족한 상태입니다.
MSI_CASH_MARK1	C
MSI_CASH_MARK2	C
MSI_ANOTHER_WORKING	다른 일을 하는 중입니다.
MSI_OVERHEAT_LIMIT_POINT	오버히트 리미트 : %d
MSI_CANNOT_JOIN_AND_LEAVE_PARTY_IN_MAKING_MEMORIALDUNGEON	메모리얼 던전 이용 중엔 초대 및 탈퇴가 되지 않습니다.
MSI_ERROR_INCLUDE_VALGARISM	비속어가 포함되어있습니다.\n다시 한번 확인해주세요.
MSI_MUST_ID_EXCEED_CHAR	아이디는 %d자 이상 입력해주세요. 사용자 계정이 없으신분들은 왼쪽 하단의 [신청] 버튼을 눌러 계정을 만드시기 바랍니다.
MSI_MUST_PASSWORD_EXCEED_CHAR	비밀번호는 %d자 이상 입력해주세요.
MSI_BANK_SYSTEM_BUSY	진행중이던 작업을 종료후 다시 시도하세요.
MSI_BASIC_EXP_MSG2_EXCEPT_PREMIUM	%.1f%% (PC방 %.1f%% + TPLUS %.1f%% + %s서버 %.1f%%)
MSI_SWAP_EQUIPITEM_CANNOT_ADD_ITEM	아이템을 등록할 수 없습니다
MSI_DAILYSENDRODEXCNT_LIMIT	/100
MSI_MAX_WEIGHT_IN_RODEX_CLIENT	/2000
MSI_TW_ENABLE_SECOND_PASSWD	https://member.gnjoy.com.tw/mRO_SecPwd.aspx
MSI_EMBLEM_CHANGE	등록할 emblem이 존재하지 않습니다. emblem 폴더에 파일을 넣고 시도해 주세요
MSI_TWITTER_TAG	라그나로크 
MSI_TWITTER_CAUTION	스크린샷에 자신 이외의 캐릭터명이 표시되는 경우나 채팅창에 자신 이외의 캐릭터 대화가 표시되는 경우, 해당 사용자에게 반드시 양해를 구한 후 사용 해 주시기 바랍니다.
MSI_SWAP_FAIL_SWAP	현재 상태에선 장비를 교체할 수 없습니다
MSI_CALLING_USERNAME	해당 유저의 이름을 가져오고 있습니다
MSI_MSG_IS_ILLEGAL_MSG	해당 메시지는 사용 할 수 없는 내용을 포함하고 있습니다.
MSI_PARA_PURCHASE_ITEM_FAIL2	아이템 구입에 실패하였습니다.
MSI_CHR_DELETE_FAIL_CHN_TAREN_PERSONALNUMBER	신분증번호 하위 7자리가 일치하지 않습니다.
MSI_CLOSE	닫기
MSI_RULE	규칙
MSI_ZENY_LOTTO_BUY_1	1회 구매
MSI_ZENY_LOTTO_BUY_10	10회 구매
MSI_ZENY_LOTTO_BUY_100	100회 구매
MSI_ZENY_LOTTO_WIN_1ST	1등 당첨
MSI_ZENY_LOTTO_WIN_2ND	2등 당첨
MSI_ZENY_LOTTO_WIN_3RD	3등 당첨
MSI_DONOT_USE_1	현재 사용하지 않음
MSI_DONOT_USE_2	현재 사용하지 않음
MSI_ZENY_LOTTO_PRIZE_WINNER	제니 로또 당첨자
MSI_ZENY_LOTTO_TOTAL_ZENY	복권 구매 금액
MSI_ZENY_LOTTO_TOTAL_CHARACTER	참여 캐릭터
MSI_WINNER_1ST	1등
MSI_WINNER_2ND	2등
MSI_WINNER_3RD	3등
MSI_ZENY_LOTTO_REWARD_ITEM	구매 보상 아이템
MSI_ZENY_LOTTO_ASK_PURCHASE	^1a1a1a복권 ^b%d개^/b를\n^4435b2%dZeny^1a1a1a로\n구매하시겠습니까?
MSI_ZENY_LOTTO_RESULT_SUCCESS	복권을 성공적으로 구매하였습니다.
MSI_ZENY_LOTTO_RESULT_FAIL_ZENY	소지 제니가 부족하여 복권을 구매 할 수 없습니다.
MSI_ZENY_LOTTO_RESULT_FAIL_COUNT	최대 복권 구매 횟수는 1000회를 초과 할 수 없습니다.
MSI_ID_YES	예
MSI_ID_NO	아니요
MSI_BASICINFO_HP	HP
MSI_BASICINFO_SP	SP
MSI_BASICINFO_LEVEL	Lv
MSI_BASICINFO_JOBLEVEL	Lv
MSI_BASICINFO_EXP	Exp
MSI_ALL_ON	 all on
MSI_REPLAY_BTN_TOOLTIP	Play Replay Flie
MSI_SIMPLECASH_P	P
MSI_SIMPLECASH_TOTAL	Total
MSI_REPLAY_BASICINFO	Basicinfo
MSI_REPLAY_EQUIP	Equip
MSI_REPLAY_ITEM	Item
MSI_REPLAY_SKILL	Skill
MSI_REPLAY_GUILD	Guild
MSI_REPLAY_PARTY	Party
MSI_REPLAY_CHATTING	Chatting
MSI_REPLAY_SHORTCUT	Shortcut
MSI_REPLAY_STATUS	Status
MSI_REPLAY_ALL	ALL
MSI_REPLAY_USER_DEFINED_FILE_NAME	User Defined File Name
MSI_REPLAY_REPEATED_FILE_CHECK	Repeated File Check
MSI_ON	on
MSI_BASIC_SKIN	<Basic Skin>
MSI_BASIC_SELECT_SKIN	Select Skin
MSI_RESULT_FAIL_ZENYLOTTO	현재 복권에 참여 중이라 삭제할 수 없습니다
MSI_ACHIEVEMENT_COMMAND	/achievement
MSI_ZENY_LOTTO_RODEX_SENDER	제니 복권
MSI_ZENY_LOTTO_RODEX_WINNER_TITLE	제니 복권 %d등 당첨 보상
MSI_ZENY_LOTTO_RODEX_WINNER_CONTENTS	%d등 당첨 보상: %s
MSI_ZENY_LOTTO_RODEX_PURCHASE_TITLE	제니 복권 누적 구매 보상
MSI_ZENY_LOTTO_RODEX_PURCHASE_CONTENTS	누적 %d회 보상: %s
MSI_ZENY_LOTTO_RODEX_REFUND_TITLE	제니 복권 구매 환불
MSI_ZENY_LOTTO_RODEX_REFUND_CONTENTS	환불 금액: %d Zeny\r\n환불 사유: 서버 내 복권 추첨 달성 실패
MSI_ADD_MINI_PARTYWND	미니 파티창 추가
MSI_DELETE_MINI_PARTYWND	미니 파티창 삭제
MSI_ZENY_LOTTO_SELL_END	복권 추첨이 모두 종료 되었습니다! 당첨자를 확인해주세요
MSI_DATE_MM_DD	%d월 %d일
MSI_ACHIEVEMENT_NEXT_GRADE	다음 등급까지
MSI_THE_WHOLE	전체
MSI_INCOMPLETE	미완료
MSI_ZENY_LOTTO_ACHIEVE	(달성!)
MSI_ZENY_LOTTO_ACHIEVE_FAIL	(미달성)
MSI_SWAP_EQUIPITEM	장비 교체
MSI_SWAP_EQUIPITEM_CHANGE	CHANGE
MSI_DESC_STR2	힘 파라메터\n ^cc0000근접 물리 공격력^ffffff, 소지무게
MSI_DESC_AGI2	민첩성 파라메터\n^cc0000공격 속도^ffffff, 회피율, 물리 방어력
MSI_DESC_VIT2	체력 파라메터\n^cc0000최대 체력^ffffff, 물리 방어력, 마법 방어력
MSI_DESC_INT2	지력 파라메터\n^cc0000마법 공격력^ffffff, 캐스팅 시간, 마법 방어력
MSI_DESC_DEX2	손재주 파라메터\n^cc0000원거리 물리 공격력^ffffff, 명중률, 캐스팅 시간, 마법 공격력
MSI_DESC_LUK2	운 파라메터\n^cc0000치명타율^ffffff, 명중률, 물리공격력, 마법공격력, 회피율
MSI_DESC_ATK2	물리 공격력
MSI_DESC_DEF2	물리 방어력
MSI_DESC_HIT2	명중률
MSI_DESC_CRI2	치명타율
MSI_DESC_GUILD2	소속길드
MSI_DESC_POINT2	각 파라메터 레벨업에 사용되는 포인트
MSI_DESC_MATK2	마법공격력
MSI_DESC_MDEF2	마법방어력
MSI_DESC_FLEE2	회피율
MSI_DESC_ASPD2	공격 속도
MSI_HOTKEY_GUIDE	단축키 안내
MSI_OPTION	옵션
MSI_SKILL_HOTKEY_F1_F9	스킬 단축키 (F1 ~ F9)
MSI_IMAGE_CAPTURE	이미지 캡쳐
MSI_ZOOM_IN	확대
MSI_ZOOM_OUT	축소
MSI_GUILD	길드
MSI_BANK	은행
MSI_MAIL	우편
MSI_CASHSHOP	캐시 상점
MSI_SIT	앉기
MSI_MOVE	이동
MSI_ROTATE	회전
MSI_CONNOT_LEAVE_MASTER	파티장은 파티장을 다른 파티원에게 위임 후 탈퇴 가능합니다.
MSI_STOP_VIDEO	이 동영상을 그만 보시겠습니까?
MSI_ITEM_IS_SWAP_EQUIPED	 장비가 장비 교체 창에 장착 되었습니다.
MSI_ITEM_IS_SWAP_REMOVED	 장비가 장비 교체 창에서 해제 되었습니다.
MSI_CANNOT_MOVE_MINI_PARTYWND	현재가 마지막 라인입니다.
MSI_BASIC_EXP_MSG_FRA	%.1f%% ( 기본 100%% + 프리미엄 %.1f%%+ %s서버 %.1f%% )
MSI_CHINESE_CHARACTER	한자
MSI_HOTKEY_SETTING	단축키 설정
MSI_EXPIRED_DATE	당신의 정액제 기간은 %s에 종료됩니다.
MSI_NOT_FOUND_REPLAY_FILE	리플레이 파일을 찾지 못하였습니다.
MSI_STORE_TABNAME_7	의상
MSI_STORE_TABNAME_8	신발
MSI_STORE_TABNAME_9	갑옷
MSI_STORE_TABNAME_10	어깨
MSI_STORE_TABNAME_11	악세
MSI_STORE_TABNAME_12	머리
MSI_ORDER	차순정렬
MSI_GENERAL_EQUIPMENT_TOOLTIP	일반 장비
MSI_SHADOW_EQUIPMENT_TOOLTIP	특수 장비
MSI_TITLE_EQUIPMENT_TOOLTIP	칭호
MSI_HELP_QUAKE_ONOFF	/quake : 화면 흔들림 효과 On/Off
MSI_HELP_AURA_EFFECT_OFF	/aura2 : 오오라를 완전히 Off 시킬 수 있습니다 On Off
MSI_GRAPHIC_SETTING_TAB_BASIC	기본 설정
MSI_GRAPHIC_SETTING_TAB_ADVANCED	고급 설정
MSI_GRAPHIC_SETTING_TOOLTIP_RESET	기본설정값이 적용됩니다. 
MSI_GRAPHIC_SETTING_WARNING_RESET	기본 설정값이 적용됩니다. 동의하십니까?
MSI_GRAPHIC_SETTING_APPLY	설정값이 적용됩니다. 동의하십니까?
MSI_GRAPHIC_SETTING_WARNING_RESTART	설정값을 적용하려면 재시작이 필요합니다. 동의하십니까?
MSI_GRAPHIC_SETTING_FOG_CHECK	안개
MSI_GRAPHIC_SETTING_SIMPLE_AURA_CHECK	오오라 간략화
MSI_GRAPHIC_SETTING_AURA_OFF_CHECK	오오라켜기
MSI_GRAPHIC_SETTING_EFFECT_CHECK	이펙트 표시
MSI_GRAPHIC_SETTING_LIGHTMAP_CHECK	음영 표시
MSI_GRAPHIC_SETTING_NOSHIFT_CHECK	No Shift
MSI_GRAPHIC_SETTING_TOOLTIP_DEVICE	하드웨어 T&L 가속기능을 선택합니다
MSI_GRAPHIC_SETTING_TOOLTIP_RESOLUTION	게임의 해상도를 선택합니다
MSI_GRAPHIC_SETTING_FULLSCREEN_CHECK	전체화면 사용
MSI_GRAPHIC_SETTING_MOUSE_EXCLUSIVE_CHECK	마우스 고정
MSI_GRAPHIC_SETTING_EFFECT_SET	이펙트 설정
MSI_GRAPHIC_SETTING_CONTROL_SET	Control 설정
MSI_GRAPHIC_SETTING_DEVICE_SET	그래픽 장치 설정
MSI_GRAPHIC_SETTING_RESOLUTION_SET	그래픽 해상도 설정
MSI_GRAPHIC_SETTING_FULLSCREEN_SET	전체 화면 유무 설정
MSI_GRAPHIC_SETTING_MOUSE_SET	마우스 고정 여부 설정
MSI_STORE_ASSISTANT_TRADE_FEE	수수료 : 
MSI_STORE_ASSISTANT_TRADE_TOTAL_FEE	수수료 총액 : 
MSI_CHATWND_RECEIVER_LIST	수신인 설정
MSI_CHATWND_RECEPTIVE_GROUP_LIST	수신그룹 설정
MSI_CHATWND_CHANGE_SIZE	크기 변경(F10)
MSI_RODEX_DOWNLOADING	메일함을 불러오는 중 입니다.\n불필요한 메일은 ^c92114삭제^000000해 주세요~!!
MSI_RODEX_NOW_LOADING	NOW LOADING..
MSI_RODEX_TITLE	제목
MSI_RODEX_SENDER	보낸이
MSI_CLOSE_SETUP	라그나로크 클라이언트와 동시에 실행이 불가능 합니다. setup을 종료합니다
MSI_OPEN_COMMAND_LIST_WND	추가 기능 설정
MSI_TAREN_LOGINREFUSE_FAIL_ACCOUNT_NOTEXIST	This account does not exist.
MSI_TAREN_LOGINREFUSE_FAIL_PASSWORD	Passwords do not match.
MSI_TAREN_LOGINREFUSE_FAIL_IP	Failed to pass IP authentication
MSI_TAREN_LOGINREFUSE_FAIL_PERSONALNUMBER	No identification number, supplement your registration information
MSI_TAREN_LOGINREFUSE_FAIL_ACCOUNT_BLOCK	Account block
MSI_TAREN_LOGINREFUSE_FAIL_SYSTEM	System error
MSI_TAREN_LOGINREFUSE_FAIL_UNKNOWN	unknown error found.
MSI_NAVIGATION_ICONTITEL	길안내 아이콘 설정
MSI_NAVIGATION_RUITELISTTITEL	길 안내 정보 UI
MSI_NAVIGATION_ROADLISTVIEW	길 안내 정보 열기
MSI_NAVIGATION_SHARETIP	현재 위치 공유
MSI_NAVIGATION_SEARCH_01	검색결과[0]
MSI_NAVIGATION_SEARCHTORUITE	검색&안내
MSI_NAVIGATION_SHARE_DESC	위치가 올바르지 않습니다.
MSI_NAVIGATION_SEARCH_02	검색결과[%d]
MSI_NAVIGATION_ICONTIP	길안내 표시를 위한 아이콘 설정
MSI_NAVIGATION_SERVICETIP	길 찾기에 zeny 허용
MSI_WORLDMAP_NAVIGATION_SET	내비게이션 도킹 해제
MSI_TAREN_LOGINREFUSE_FAIL_NOTACTIVATED	활성화 하지 않은 계정입니다.
MSI_NAVIGATION_V4_HELP	클릭한 위치가 채팅창에 공유 됩니다.
MSI_NAVIGATION_V4_HELP01	4. Service 항목을 선택하면 Zeny&비공정 이용을 고려하여 안내 한다.
MSI_NAVIGATION_V4_HELP02	5. [<-] 버튼 : 길안내 모드 <-> 검색 모드를 바꾸거나
MSI_NAVIGATION_V4_HELP03	공유하기 모드 -> 서치 모드로 돌아갈때 사용 된다.
MSI_GOT_EXPERIENCE_POINT_INT64	경험치 %lld 얻음
MSI_NOTIFY_EXP_INT64	'%lld'의 경험치를 
MSI_CHARGE_FEE_HELP	^b- 노점 수수료 안내^/b\n노점 설정 가격에 따라 일정 비율의 수수료가 부가됩니다.\n^b- 노점 개설 제한 안내^/b\n캐릭터의 보유제니와 판매 물품의 총판매가가 2,147,483,647 이상일 경우 노점 개설이 불가합니다.\n
MSI_METCHANT_SHOP_PRICE_INCLUDED_CHARGE_FEE	실거래가 : 
MSI_WARNING_METCHANT_SHOP_SELL	※ 아이템 판매시, 실거래가만큼 제니를 획득합니다.
MSI_WARNING_METCHANT_SHOP_BUY	※ 아이템 구매시, 실거래가만큼 제니가 차감됩니다.
MSI_MAKE_CHAT_ROOM	채팅방 개설
MSI_CANNOT_JOIN_CHARACTER_HAVING_LOW_SKILL	해당 캐릭터는 파티가입이 가능하지 않은 레벨입니다.
MSI_NOTIFY_JOBEXP_INT64	'%lld'의 잡경험치를 
MSI_GOT_JOB_EXPERIENCE_POINT_INT64	잡경험치 %lld 얻음
MSI_MERCHANTSHOP_FAIL_POSITION	현재위치(대로)에는 노점을 개설할 수 없습니다.
MSI_SWAP_EQUIPITEM_WAITING	초 후 가능합니다.
MSI_PARTYMEMBER	파티원
MSI_CONNECT_SNS_FAIL_SEND	SNS 전송실패(%d)
MSI_CONNECT_SNS_FAIL_CONNECT	SNS 서버 연결실패
MSI_CONNECT_SNS_FAIL_CUZ_NOT_CONNECTING	SNS 로그인 후 사용 가능합니다.
MSI_CONNECT_NOT_HAVE_URL	접속 할 수 있는 주소가 존재하지 않습니다.
MSI_GET_OFF_MINI_PARTYWND	미니파티창이 겹쳐져 있어 사용하실 수 없습니다.
MSI_SALESTORE_MYSHOPWND_TITLE	나의 판매노점
MSI_TIPBOX	BOX
MSI_MENUICON_TIPBOX	팁박스
MSI_CONNECT_SNS_SUCCESS_SEND	트윗을 성공했습니다.
MSI_AGAIN	다시하기
MSI_REFINING_AGAIN_FAILED_INGREDIENT_CHANGED	다시하기가 비활성화되었습니다. 제련 재료를 다시 선택해주세요.
MSI_REFINING_AGAIN_FAILED_LACK_OF_INGREDIENT	제련석이 부족하여 다시하기가 비활성화 되었습니다.
MSI_REFINING_AGAIN_FAILED_LACK_OF_MONEY	제니가 부족하여 다시하기가 비활성화 되었습니다.
MSI_REFINING_AGAIN_FAILED_LACK_OF_BLACKSMITHBLESSING	대장장이의 축복이 부족하여 다시하기가 비활성화 되었습니다.
MSI_REFINING_FAIL_BROKEN_ITEM	아이템이 파괴되었습니다.
MSI_NPC_ALL_STAT_DOWN	모든 스테이터스가 감소되었습니다.
MSI_NPC_ALL_STAT_DOWN_RESET	모든 스테이터스 감소 효과가 해제되었습니다.
MSI_OTP_MUST_8_CHAR	OTP 비밀번호는 8자리 입니다.
MSI_ACCOUNTCLASS_INTEGRATION	통합계정
MSI_ACCOUNTCLASS_RAGNAROK	라그나로크
MSI_FAIL_SERVICE_CHECKING_ERROR	서비스 점검 중입니다.
MSI_ENTER_THE_SEARCH_WORD	검색어를 입력해주세요
MSI_MOTP	MOTP
MSI_AUTHORIZATION_CODE	인증번호
MSI_ENTER_YOUR_AUTHENTICATION_NUMBER	휴대폰에 다운받은 GNJOY MOTP를 실행하여 인증번호를 입력해 주세요.
MSI_PARTY_DO_YOU_WANT_BREAKING_UP	파티장을 위임할 파티원이 존재하지 않습니다. 파티를 해산하시겠습니까?
MSI_SERVER_PROPERTY_ADULT_NO_COUNT	 - 만18세이상
MSI_SERVER_PROPERTY_PAY_NO_COUNT	 - 유료서버
MSI_SERVER_PROPERTY_FREE_NO_COUNT	 - 무료서버
MSI_SERVER_USERCOUNT_STATE_NICE	쾌적
MSI_SERVER_USERCOUNT_STATE_NORMAL	보통
MSI_SERVER_USERCOUNT_STATE_BUSY	혼잡
MSI_SERVER_USERCOUNT_STATE_VERY_BUSY	포화
MSI_MENUICON_MAP	map
MSI_WORLDSTORE_ONLY_INVENTORY	월드창고는 인벤토리 아이템만 입출고 할 수 있습니다.
MSI_WORLDSTORE_PUT_BLOCK_PETEGG	월드창고에는 펫알을 입고할 수 없습니다.
MSI_WORLDSTORE_PUT_BLOCK_MANUFACTUREDITEM	월드창고에는 제작아이템을 입고할 수 없습니다.
MSI_WORLDSTORE_OUT_BLOCK	%s 에서는 출고 할 수 없는 아이템입니다.
MSI_MEMORIAL_DUN_DESTROY	던전 파괴
MSI_BROADCASTING_REFINING_SUCCESS_LEVEL_9	[%s] 님이 제련을 성공하여, [+%d %s] 아이템을 획득하였습니다.
MSI_BROADCASTING_REFINING_FAIL_LEVEL_9	[%s] 님이 [+%d %s] 아이템의 제련에 실패하였습니다.
MSI_PARTY_NOT_LEAVE_PARTY_UNTIL_YIELD_PARTYMASTER	파티장을 위임한 이후에 탈퇴할 수 있습니다.
MSI_ASCENDING_ORDER	오름
MSI_DESENDING_ORDER	내림
MSI_DEFAULT	기본
MSI_CHEATDEFENDER_FILE_CHECK_FAIL	변조된 파일이 발견되었습니다. 게임을 다시 실행시켜주세요.
MSI_ITEMMOVERESTRICT_WHITELIST	%s 은(는) 이맵에서 이동이 제한된 아이템입니다.
MSI_HOMUN_SELF_FEEDING	스스로\n먹이먹기
MSI_FAILED_HOMUN_SELF_FEEDING_CLOSE_RODEX	로덱스 작성창이 열려있는 동안 호문클루스가 먹이를 먹지 못합니다.
MSI_HOMUN_SELF_FEEDING_REST	호문클루스가 먹이를 먹었습니다. \'%s\' 잔여량 %d개
MSI_HOMUN_SELF_FEEDING_ON	호문클루스 스스로 먹이 먹기 활성화 On
MSI_HOMUN_SELF_FEEDING_OFF	호문클루스 스스로 먹이 먹기 활성화 Off
MSI_HOMUN_SELF_FEEDING_EXP_INFORMATION	호문클루스는 주인이 획득하는 경험치의\n10%만큼을 자신의 경험치로 분배 받습니다.
MSI_REFINING_RATE	확률 : %d%%
MSI_HOMUN_TARGET_IS_NOT_HOMUN_TARGET	해당 대상은 호문의 공격대상이 아닙니다. \'Alt + 우클릭\'을 통해 호문클루스의 공격대상을 지정해주세요.
MSI_HOMUN_TARGET_NOT_EXIST_HOMUN_TARGAT	호문의 공격대상이 존재하지 않습니다. \'Alt + 우클릭\'을 통해 호문클루스의 공격대상을 지정해주세요.
MSI_CASHSHOP_SALE_LIST	판매 리스트
MSI_CASHSHOP_BUY_LIST	구입 리스트
MSI_CASHSHOP_TAB_NEW	신규
MSI_CASHSHOP_TAB_HOT	인기
MSI_CASHSHOP_TAB_LIMITED	특별 상품
MSI_CASHSHOP_TAB_LEASE	임대장비
MSI_CASHSHOP_TAB_PERMANENT	영구장비
MSI_CASHSHOP_TAB_BUFF	버프
MSI_CASHSHOP_TAB_RECOVERY	회복
MSI_CASHSHOP_TAB_ETC	기타
MSI_CASHSHOP_TAB_BARGAIN	특가
MSI_CASHSHOP_CASH_CHARGE	충전하기
MSI_CASHSHOP_ITEM_BUY	구입하기
MSI_CASHSHOP_CASH_CHARGE_ADDRESS	http://member.gnjoy.com/user/pay/chargelist.asp
MSI_ITEM_SEARCH	아이템 검색
MSI_CASHSHOP_FREE_POINT	무료캐시
MSI_CASHSHOP_FREE_POINT_TO_USE	무료캐시 사용
MSI_CASHSHOP_CASH_POINT	소지캐시
MSI_CASHSHOP_REFRESH	수량갱신
MSI_STAR_EMPEROR_F	성제(여)
MSI_SOUL_REAPER_F	소울리퍼(여)
MSI_STAR_EMPEROR_M	성제(남)
MSI_SOUL_REAPER_M	소울리퍼(남)
MSI_NO_RECOVER_OVERWEIGHT2	무게가 %d 퍼센트 이상일때는 HP SP가 자연적으로 회복이 되지 않습니다.
MSI_CASHSHOP_CANNOT_BUY_OVER	한 번에 구입 가능한 아이템의 가짓수는 8개입니다.
MSI_OUTSIDE_CASHSHOP_LINK	http://gift.zhaouc.com/
MSI_USA_LOGINERRORMSG_UNKNOWN	UNKNOWN ERROR:%d
MSI_USA_LOGINERRORMSG_NOT_USER	NOT USER
MSI_USA_LOGINERRORMSG_ID_BLOCK	THIS ACCOUNT ID IS BLOCKED
MSI_USA_LOGINERRORMSG_ID_INACTIVAT	COUNTRY REJECT (OR NOT AVALIABLE USER )
MSI_USA_LOGINERRORMSG_PASSWORD	NOT MATCH PASSWORD
MSI_USA_LOGINERRORMSG_EMAIL_CERT	NOT EMAIL CERT
MSI_USA_LOGINERRORMSG_PAYPAL_BLOCK1	PAYPAL BLOCK
MSI_USA_LOGINERRORMSG_COUNTRY_REJECT	COUNTRY REJECT
MSI_USA_LOGINERRORMSG_PAYPAL_BLOCK2	PAYPAL BLOCK
MSI_USA_LOGINERRORMSG_WEB_BLOCK	WEB BLOCK
MSI_USA_LOGINERRORMSG_AGE	AGE LIMIT USER
MSI_USA_LOGINERRORMSG_PASSWORD_CHANGE	PASSWORD HAS NOT BEEN CHANGED FOR MORE THAN 90DAYS
MSI_USA_LOGINERRORMSG_INPUTDATA	INPUT DATA ERROR
MSI_USA_LOGINERRORMSG_DATABASE	ERROR DATABASE
MSI_USA_LOGINERRORMSG_SYSTEM	ERROR SYSTEM
MSI_PAY_BY_ITEM	%s 소모
MSI_PRIVATE_AIRPLANE_PAYMENT	비용지불
MSI_PRIVATE_AIRPLANE_FAILED_ISNOT_STARTABLE_MAP	출발 가능한 맵이 아닙니다.
MSI_PRIVATE_AIRPLANE_FAILED_ISNOT_ENDABLE_MAP	이동 불가능한 맵입니다
MSI_PRIVATE_AIRPLANE_FAILED_NOT_ENOUGH_ITEM	아이템이 부족합니다.
MSI_ENTER_ONE_LINE_WITHOUT_LINE_BREAKS	줄 바꿈 없이 한 줄로 입력해주세요.
MSI_CANNOT_REGISTER_NAME_THAT_CONTAINS_BADWORDS	불량 단어가 포함된 이름은 등록할 수 없습니다.
MSI_CREATE_ACCOUNT	회원 가입을 위해 공식 홈페이지로 이동됩니다.
MSI_TOKENAGENCY_SERVER_CONNECTION_FAILED	TokenAgency 서버 연결 실패
MSI_SELECTCHARWND_BILLING_INFO	과금정보
MSI_SELECTCHARWND_RESERVE_TO_DEL_CHAR	삭제예약
MSI_SELECTCHARWND_CANCEL_TO_RESERVE_CHAR	예약취소
MSI_SELECTCHARWND_START_GAME	게임시작
MSI_SELECTCHARWND_DELETE	삭제
MSI_SELECTCHARWND_CHARACTER_LIST	Character List
MSI_SELECTCHARWND_NOTICE	공지
MSI_MAKECHARWND_CREATE	생성
MSI_MAKECHARWND_HAIR_STYLE	Hair Style
MSI_MAKECHARWND_HAIR_COLOR	Hair Color
MSI_MAKECHARWND_DOUBLECHECK_NAME	중복확인
MSI_DATE_HH_MM_SS	%d시 %d분 %d초
MSI_INPUT_TIME_EXCEEDED_SIGN_IN_AGAIN	MOTP 입력 시간이 초과되었습니다. 처음부터 다시 로그인해주십시오.
MSI_MAKECHARWND_CLOSE	뒤로가기
MSI_PRIVATE_AIRPLANE_FAILED_USE_ITEM	아이템을 사용할 수 없습니다.
MSI_PRIVATE_AIRPLANE_FAILED_SAME_MAP	동일한 맵으로 이동할 수 없습니다.
MSI_PRIVATE_AIRPLANE_FAILED_DEAD_STATE	사망시 이동이 불가능합니다.
MSI_MAKECHARWND_TITLE	캐릭터 생성
MSI_REGISTER_ADVENTURER_AGENCY	모험가 중개소 등록
MSI_REGISTER_ADVENTURER_AGENCY2	모험가 중개소 등록하기
MSI_STOP_RECRUITING	모집 중단
MSI_ADVEN_MEMO	메모
MSI_ADVEN_QUEST	퀘스트
MSI_ADVEN_FIELD	필드
MSI_ADVEN_DUNJUN	던전
MSI_ADVEN_MD	MD
MSI_ADVEN_EDEN_GROUP	낙원단
MSI_ADVEN_ETC	기타
MSI_ADVEN_SEARCH	검색
MSI_ADVEN_RESET	초기화
MSI_ADVEN_JOIN_PARTY	파티가입신청
MSI_ADVEN_PURPOSE	목적
MSI_ADVEN_WARNING_TEXT	※욕설, 현거래등 운영 규칙에 위배되는 목적으로 사용 시 처벌 받을 수 있습니다.
MSI_ADVEN_REGISTER	등록하기
MSI_INCLUDE_BAD_WORD	사용할 수 없는 단어가 포함되어 있습니다.
MSI_ASK_JOIN	파티가입
MSI_CHAT_WITH_PARTYMASTER	1:1대화
MSI_STOP_RECRUITING_PARTY	모집 중지
MSI_ADVEN_REWRITE	수정하기
MSI_ALL_AREA	전체
MSI_REQUEST_PARTY	[%s] 님이 파티가입을 신청했습니다.
MSI_LOGIN	로그인
MSI_ACCOUNT	계정
MSI_EXIT	종료
MSI_APPLY	신청
MSI_CONNECT	접속
MSI_OK	확인
MSI_OTPWND_DESCRIPTION_1	휴대폰에 다운받은 GNJOY MOTP를
MSI_OTPWND_DESCRIPTION_2	실행하여 인증번호를 입력해 주세요.
MSI_PRIVATE_AIRPLANE_WARNNING_SELECT_NPC	NPC가 있는 맵의 랜덤 좌표로 이동 됩니다.
MSI_JOBNAME_TAEKWON	태권
MSI_TO_BLOCK_WHISPER	 에게 전체채팅 및 귓말 거부상태
MSI_TO_BLOCK_WHISPER_FAILED1	 에게 전체채팅 및 귓말 거부 요청 실패
MSI_TO_BLOCK_WHISPER_FAILED2	 에게 전체채팅 및 귓말 거부 요청실패 (인원초과)
MSI_TO_UNBLOCK_WHISPER	 에게 전체채팅 및 귓말 가능상태
MSI_TO_UNBLOCK_WHISPER_FAILED1	 에게 전체채팅 및 귓말 가능 요청실패
MSI_TO_UNBLOCK_WHISPER_FAILED2	 에게 전체채팅 및 귓말 가능 요청실패 (인원초과)
MSI_NO_BLOCK_LIST	차단 리스트가 없습니다
MSI_BLOCK_LIST	-차단 리스트-
MSI_RENEW_QUEST_TAB_PROCESS	진행중
MSI_RENEW_QUEST_TAB_BEST	추천
MSI_RENEW_QUEST_TAB_HOLD	보류중
MSI_RENEW_QUEST_TITLE	QUEST
MSI_RENEW_QUEST_DETAIL_DESCRIPTION	내용
MSI_RENEW_QUEST_DETAIL_MONSTER	몬스터
MSI_RENEW_QUEST_DETAIL_REWARD	보상
MSI_RENEW_QUEST_DETAIL_EXP	EXP
MSI_RENEW_QUEST_DETAIL_JEXP	JEXP
MSI_RENEW_QUEST_DETAIL_ITEM	아이템
MSI_RENEW_QUEST_CHECK_TOOTIP1_ITEM	진행/보류
MSI_RENEW_QUEST_CHECK_TOOTIP2_ITEM	하단으로 이동
MSI_RENEW_QUEST_CHECK_TOOTIP3_ITEM	간편 퀘스트창에 표시
MSI_OTP_INPUT_TIME	입력시간
MSI_SAVE_ID	아이디 저장
MSI_PASSWORD	비밀번호
MSI_ID	아이디
MSI_CREATE_RAG_ACCOUNT	회원가입
MSI_PARTY_MASTER	파티장
MSI_CANNOT_APPLY_LEVEL	파티에 가입할 수 있는 레벨이 아닙니다.
MSI_ADVENTURER_AGENCY_REGIST_FAILED	모험가 중개소 등록에 실패했습니다.
MSI_ADVENTURER_AGENCY_REGIST_SUCCESSED	모험가 중개소에 등록되었습니다.
MSI_INPUT_SEARCH_TEXT	검색내용입력
MSI_ADVEN_TANKER	탱커
MSI_BASIC_EXP_ZERO	%.1f%% (+ %s서버 %.1f%%)
MSI_EXPLAIN_CHAT_BLOCK	/ex (캐릭터이름) or /차단 (캐릭터이름) : 해당 캐릭터에 대해 전체채팅 및 귓말 차단
MSI_EXPLAIN_CHAT_UNBLOCK	/in (캐릭터이름) or /해제 (캐릭터이름) : 해당 캐릭터에 대해 전체채팅 및 귓말 허용
MSI_EXPLAIN_CHAT_BLOCKLIST	/ex or /차단 : 전체채팅 및 귓말 차단 캐릭터 리스트
MSI_EXPLAIN_CHAT_BLOCK_TO_ALL	/exall or /차단전부 : 모두에게 전체채팅 및 귓말 차단
MSI_EXPLAIN_CHAT_UNBLOCK_TO_ALL	/inall or /해제전부 : 모두에게 전체채팅 및 귓말 허용
MSI_REFUSE_CHAT_TO_EVERYONE	모두에게 전체채팅 및 귓말 거부상태
MSI_FAILED_TO_ALL_CHAT_PERMIT	모두에게 전체채팅 및 귓말 거부요청 실패
MSI_PERMIT_CHAT_TO_EVERYONE	모두에게 전체채팅 및 귓말 가능상태
MSI_FAILED_TO_ASK_ALL_CHAT	모두에게 전체채팅 및 귓말 가능요청 실패
MSI_OPENING	오프닝
MSI_DO_YOU_WANT_TO_BACK_LOGINWND	로그인 화면으로 돌아가시겠습니까?
MSI_ENST_SHOUT2	힘과 공격력이 강해졌습니다.
MSI_ENST_BLESSING2	힘, 지능, 손재주 및 명중률이 증가하였습니다.
MSI_ENST_ANGELUS2	방어력 및 HP가 증가되었습니다.
MSI_CASHSHOP_TAB_JELLSTAR	젤스타
MSI_CASHSHOP_TAB_EFST_AID	계정버프
MSI_CASHSHOP_TAB_PREMIUM_SERVICE	정액서비스
MSI_REFUSE_RETRY_CONNECT_AC	현재 접속이 지연되고 있습니다. 순차적으로 접속이 가능하니 잠시 후 재접속 부탁드립니다.
MSI_REFUSE_RETRY_CONNECT_TC	현재 접속이 지연되고 있으니 잠시 후 재접속 부탁드립니다.
MSI_CANNOT_FIND_NAME_THAT_CONTAINS_BADWORDS	불량 단어가 포함된 이름은 검색할 수 없습니다.
MSI_THE_PARTY_MASTER_CANNOT_BE_REQUESTED	파티 마스터가 요청을 받을 수 없는 상태입니다.
MSI_NO_PARTY_FOUND	파티를 찾을 수 없습니다.
MSI_ADVEN_DEARER	딜러
MSI_WEB_ADDRESS_FOR_RESTART	http://ro.gnjoy.com
MSI_QUESTWND_HIGHER	▲
MSI_QUESTWND_LOWER	▼
MSI_FRIEND_ALREADY_FRIEND	이미 친구입니다
MSI_FRIEND_CAN_NOT_FIND	상대방을 찾을 수 없습니다
MSI_FRIEND_ALREADY_JOINING	이미 다른 캐릭터가 친구 신청 중입니다.
MSI_SPRITEMABLE_ON	혼구슬 표시 ON
MSI_SPRITEMABLE_OFF	혼구슬 표시 OFF
MSI_BAN_BLOCK_CHARCTER_SERVER_SECOND_PASSWORD	해당 계정은 2차 비밀번호 오입력으로 인해 게임내 접속이 제한된 상태입니다. \n %02d시간 %02d분 후에 접속제한이 해제되며, 접속제한의 해제는 홈페이지 -> 개인정보변경 -> 2차 비밀번호 에서 본인인증 후 진행해주시기 바랍니다.
MSI_SECOND_PASSWORD_INFO_5	보안패스워드를 3회이상 틀리셨습니다. 계정 보안을 위해 24시간동안 게임내 접속이 제한됩니다.\n 접속제한의 해제는 홈페이지 -> 개인정보변경 -> 2차 비밀번호 에서 본인인증 후 진행해주시기 바랍니다.
MSI_CHECK_ATTENDANCE_RODEX_SENDER	운영진
MSI_CHECK_ATTENDANCE_RODEX_CONTENTS	%d일차 출석 보상이 지급되었습니다.
MSI_ACCOUNTLINKEDUSERDATA_LOAD_FAIL	계정 설정 데이터를 불러오는 중에 오류가 발생했습니다. ( 재시도를 위해서는 재시작 해야 합니다. )
MSI_USESKILL_FAIL_NOT_PARTY_MEMBER	해당 스킬은 파티 상태에서 사용 가능합니다.
MSI_ADVENTURER_AGENCY_RECRUIT_STOP	파티 모집을 중단하였습니다.
MSI_CANNOT_OFFER_GUILD_EXP_MAX_RATE	길드 상납 경험치는 최대 %d%%까지 가능합니다.
MSI_CANNOT_OFFER_GUILD_EXP_MAX_LEVEL	길드 레벨이 최대여서 더 이상 경험치를 상납할 수 없습니다.
MSI_FORCED_WEB_LOGIN	계정보안을 위하여 MOTP미사용자는 홈페이지 로그인만 가능합니다.\n홈페이지로 로그인을 시도해주시기 바랍니다.
MSI_INC_ATTACKDAMAGE_ABILITYPOWER	물리 공격력과 마법 공격력이 향상되었습니다.
MSI_DEC_ATTACKDAMAGE_ABILITYPOWER	물리 공격력과 마법 공격력이 감소되었습니다.
MSI_CHECK_ATTENDANCE_REWARD	%s 출석체크 보상
MSI_CHECK_ATTENDANCE_DATE_INFO	이벤트 기간 : %02d월 %02d일 ~ %02d월 %02d일 24:00까지
MSI_CHECK_ATTENDANCE_DATE_COUNT	%d일차
MSI_CHECK_ATTENDANCE_CHECK_BEFORE	%d일차 출석체크\n클릭해주세요~!
MSI_CHECK_ATTENDANCE_CHECK_AFTER	%d일차 출석 성공!
MSI_CHECK_ATTENDANCE_DDAY	D-day
MSI_DATE_DAY	일
MSI_CHECK_ATTENDANCE_FAIL_RESTART	출석체크에 실패하였습니다. 다시 실행해주세요.
MSI_CHECK_ATTENDANCE	출석체크
MSI_CHECK_ATTENDANCE_NOT_EVENT	현재 출석체크 이벤트 기간이 아닙니다
MSI_CAN_NOT_OFFER_EXP_TO_GUILD_MAX_LV	길드 상납 경험치가 max에 도달하여, 더 이상 길드 경험치를 누적할 수 없습니다.
MSI_CAN_NOT_OFFER_EXP_TO_GUILD_MAX_EXP	개인 상납 경험치가 max에 도달하여, 더 이상 길드 경험치를 누적할 수 없습니다.
MSI_MESSAGEWND_TITLE	메시지
MSI_SEND_TO_TWITTER_FAILED	트위터에 메세지 전송을 실패 했습니다.
MSI_KEYWORD_FILTER	영문 4자, 한글 2자 이상으로 입력해야 합니다.
MSI_DISABLE_TAMINGMONSTER_MAP	몬스터의 테이밍이 불가능한 지역입니다.
MSI_RANK_LOADING	순위를 가져오고 있습니다...
MSI_USESKILL_FAIL_NOT_PARTY_MASTER	해당 스킬은 파티장일때만 사용 가능합니다.
MSI_USESKILL_FAIL_ENSEMBLE_PARTYNER	파트너의 SP가 부족하거나, 스킬 사용 불가 상태입니다.
MSI_STORE_ASSISTANT_TRADE_FORCED_REMOVAL_TITLE	아르바이트 노점 강제 종료 알림메일
MSI_STORE_ASSISTANT_TRADE_FORCED_REMOVAL_CONTENT	안녕하세요. 운영팀입니다.\r\n해당 아르바이트 노점은 운영정책 위배되는 사항이 확인되어 강제 종료되었습니다.\r\n자세한 확인을 원하시는 경우에는 1:1 문의를 접수해 주시기 바랍니다.\r\n감사합니다
MSI_CAN_NOT_OFFER_EXP_LIMIT_RATE	50% 이상의 값을 입력할 수 없습니다.
MSI_CANNOT_CHANGE_PARTYMASTER	파티가 모험가 중개소에 등록되어, 파티장을 변경 할 수 없습니다.
MSI_CANNOT_REGISTER_PARTY	모험가 중개소에 파티를 등록할 수 없습니다
MSI_ACCEPT	수락
MSI_REFUSE	거절
MSI_ADVEN_HEALER	힐러
MSI_CANNOT_FIND_REQUEST_USER	해당 캐릭터를 찾을 수 없습니다.
MSI_STORE_ASSISTANT_TRADE_FORCED_REMOVAL	노점 강제 철거
MSI_CANNOT_FIND_PARTYMASTER	해당 파티의 파티장을 찾을 수 없습니다.
MSI_CANNOT_JOIN_PARTY_BECAUSE_LOW_LEVEL	잡레벨이 낮아 파티에 가입 할 수 없습니다.
MSI_INVALID_MAPPROPERTY_REQUEST_USER	현재 요청자가 파티가입이 불가능한 지역에 있습니다.
MSI_EXCEEDED_NUMBER_OF_PARTYMEMBERS	파티 인원수가 초과되었습니다.
MSI_JOIN_ACCEPT	%s 파티의 파티장이 파티 가입을 승인했습니다.
MSI_JOIN_REFUSE	%s 파티의 파티장이 파티 가입을 거부했습니다.
MSI_ALREADY_JOINED_REQUEST_USER	%s 님이 이미 파티에 가입 중입니다.
MSI_JOIN_ACCEPT_REQUEST_USER	%s 님의 파티 가입을 수락했습니다.
MSI_JOIN_REFUSE_REQUEST_USER	%s 님의 파티 가입을 거부했습니다.
MSI_REQUEST_REJECTED_BECAUSE_INVALID_MAPPROPERTY	파티 요청을 받을 수 없는 상태여서 %s님의 신청이 거절되었습니다.
MSI_ADVENTURER_AGENCY_LIST	모험가 중개소 리스트
MSI_REQUEST_JOIN_PARTY	파티 가입 요청
MSI_NOT_PARTYMASTER_CANNOT_REGISTER_ADVENTURER_AGENCY	파티장이 아닌 경우 모험가 중개소에 파티를 등록할 수 없습니다.
MSI_ADVENTURER_AGENCY_RECRUIT_STOP_FAILED	파티 모집을 중단할 수 없습니다.
MSI_ADVEN_ASSIST	보조
MSI_EXPAND_SIGHT_OPTIONWND	Zoom Out
MSI_EXPAND_SIGHT_HELP	%s : Zoom Out을 켜거나 끌수 있습니다 On Off
MSI_EXPAND_SIGHT_ON	Zoom Out 기능을 켭니다 (On)
MSI_EXPAND_SIGHT_OFF	Zoom Out 기능을 해제합니다 (Off)
MSI_EXPAND_SIGHT	/zoom
MSI_ADVENTURER_AGENCY	모험가 중개소
MSI_CANNOT_ASK_TO_JOIN_PARTY	파티장인 경우, 가입 요청을 할 수 없습니다.
MSI_CHECK_LEVEL_BEFORE_REGISTER_AGENCY	파티 가입 최대 레벨은 최소 레벨 설정보다 높아야 합니다.
MSI_CANNOT_MORE_SELECT_JOB	더 이상 직업을 선택할 수 없습니다.
MSI_D0_NOT_RECEIVE_THE_USER_REQUEST_TODAY	게임 중 해당 유저의 가입 요청을 받지 않습니다.(클라이언트 종료 전까지 유효)
MSI_PLEASE_REOPEN_LISTWND_AFTER_A_WHILE	잠시 후 다시 열어주시기 바랍니다.
MSI_BEFORE_SIEGE_BLOCKMOVE_TIME	공성시작 전 %d분 동안은 해당 기능을 이용하실 수 없습니다.
MSI_EXPAND_OBJALPHA	/viewclear
MSI_HALFALPHAOBJ_ON	건물 반 투명화 ON
MSI_HALFALPHAOBJ_OFF	건물 반 투명화 OFF
MSI_GRAPHIC_SETTING_OBJALPHA	건물 투명화
MSI_FAILED_PET_TO_EGG_CLOSE_RODEX	알로 되돌리기가 실패했습니다. 로덱스 작성창을 닫아주세요.
MSI_EMBLEM_FRAME	Emblem Frame
MSI_EMBLEM_FRAME_DRAW_ON	Emblem 테두리를 그려줍니다
MSI_EMBLEM_FRAME_DRAW_OFF	Emblem 테두리를 그려주지 않습니다
MSI_USESKILL_FAIL_NEED_EQUIPPED_WEAPONE	장착된 무기가 없습니다.
MSI_USESKILL_FAIL_EMPTY_SOUL_ENERGY	에너지 구체가 부족합니다.
MSI_ADDSKILL_FAIL_INCLUDE_SKILL_YOU_CANNOT_LEARN	배울 수 없는 스킬(%s)이 포함되어있습니다.
MSI_DRAW_EMBLEM_FRAME_ONOFF	/frame
MSI_USESKILL_FAIL_GC_WEAPONBLOCK_ON	웨폰 블로킹 발동후 제한시간 내에 사용가능한 스킬입니다.
MSI_REFUSE_LOGIN_AUTH	아이디혹은 패스워드가 잘못되었읍니다.
MSI_RUSSIA_PERSONALINFO_EXP	E X P : %.1f%% ( basic 100.0%% %s %.1f%%)
MSI_RUSSIA_PERSONALINFO_DROP	DROP  : %.1f%% ( basic 100.0%% %s %.1f%%)
MSI_RUSSIA_PERSONALINFO_DEATH	DEATH : %.1f%% ( basic 100.0%% %s %.1f%%)
MSI_RUSSIA_CHAR_NAME_RULES	영문이나 러시아어 단독으로만 사용이 가능합니다.
MSI_REFUSE_LOGIN_ACCESSTICKET	you must have an AccessTicket to login
MSI_ITEMSTORE_DOWNLOADING	창고를 불러오는 중입니다.
MSI_ITEMSTORE_NOW_LOADING	NOW LOADING..
MSI_RODEX_BUTTON_DELETE	삭제
MSI_RODEX_BUTTON_ANSWER	답장
MSI_RODEX_BUTTON_SEND	전송
MSI_RODEX_BUTTON_CONFIRM_ID	이름확인
MSI_RODEX_TAB_ADMIN	공지
MSI_RODEX_TAB_DEFAULT	일반
MSI_RODEX_TAB_RETURN	반송
MSI_RODEX_TAB_SEARCH	검색
MSI_FAILED_PET_AUTO_FEEDING_BY_ITEMACTION	펫 먹이주기에 실패했습니다. 먹이를 줄 수 없는 상태입니다.
MSI_FAILED_HOMUN_AUTO_FEEDING_BY_ITEMACTION	호문 먹이주기에 실패했습니다. 먹이를 줄 수 없는 상태입니다.
MSI_MSI_INVENTORY_TABNAME_4	화폐
MSI_BARTERITEM_NAME_COUNT	%s %d개
MSI_EXCHANGED_FAILED	교환에 실패하였습니다.
MSI_EXCHANGED_SUCCEEDED	교환이 잘 이루어졌습니다.
MSI_NO_ITEM_FOR_EXCHANGE	교환에 필요한 재화가 부족합니다.
MSI_ITEM_OUT_OF_STOCK	해당 아이템은 이미 판매되어 재고가 부족합니다.
MSI_DEAD	사망
MSI_PVP	PvP
MSI_INVENTORY_EXTEND_OF_BODYITEM	아이템 소지 확장
MSI_INVENTORY_EXTEND	^0000ff%s^000000을 소모하여, 아이템 최대 소지 종류수를 확장하시겠습니까? \n(^0000ff%d^000000)에서 (^0000ff%d^000000)로 확장됩니다.\n^ff0000※ 소모된 아이템 및 확장된 최대 소지 종류수는 되돌릴 수 없습니다.^000000
MSI_INVENTORY_EXTEND_FAILED	아이템 최대 소지 종류수 확장에 실패하였습니다.
MSI_INVENTORY_EXTEND_FAILED_ANOTHER_WORK	아이템 최대 소지 종류수 확장을 위해, 다른 작업을 종료하여 주시기 바랍니다.
MSI_INVENTORY_EXTEND_FAILED_NO_ITEM	아이템 최대 소지 종류수 확장에 필요한 아이템을 소지하고 있지 않습니다.
MSI_INVENTORY_EXTEND_FAILED_MAX_OVER	더 이상 아이템 최대 소지 종류수를 확장 할 수 없습니다.
MSI_INVENTORY_EXTEND_SUCCESS	아이템 최대 소지 종류수 확장에 성공하였습니다.
MSI_LIMIT_BUY_ITEM3	같은 아이템을 %d개 이상 가질 수 없습니다.
MSI_EXCEED_LIMITED_ITEMNUM	소지 한계량 초과로 구입이 불가능합니다.
MSI_BUY_ONE_AT_A_TIME	해당 아이템은 한 번에 한 개만 살 수 있습니다.
MSI_STAR_EMPEROR	성제
MSI_SOUL_REAPER	소울리퍼
MSI_SAVE_HOTKEY_TO_SERVER	설정한 내용은 정상 종료 시 서버에 저장됩니다.
MSI_TRANSLATE_CAPTURE_MONSTER	Capture Monster
MSI_TRANSLATE_MESSAGE	message
MSI_TRANSLATE_TITLE	TITLE
MSI_EXTEND_DAMAGE_RANGE	데미지 표기 확장
MSI_SHOW_NAME_OF_ENTERED_MAP	맵 이름 표기
MSI_SYSTEM_MSG_MERCHANTSHOP	시스템 메세지 : 현재 노점보기 기능이 %s 상태입니다. (/노점보기)
MSI_VSYNC	수직 동기
MSI_WEBSITE_LINK_BTN_TOOLTIP	자료
MSI_WEBSITE_LINK_ADDRESS	http://rodata.zhaouc.com/renwu.html
MSI_OUTSIDE_CASHSHOP_BTN_TOOLTIP	작위
MSI_LIMIT_FRAME	프레임 제한
MSI_USESKILL_FAIL_OVER_INSTALLATION	%d개를 초과할 경우 더 이상 설치 할 수 없습니다.
MSI_NAVIGATION_DESTINATION	목적지
MSI_EMBLEM_UPLOAD_FAILED_BUSY	잠시 후 다시 시도해주세요.
MSI_EMBLEM_REGIST_FAILED_INCORRECT_SIZE	등록할 수 없는 파일입니다.
MSI_RODEX_BUTTON_DELETE_SELECTED	선택 삭제
MSI_RODEX_BUTTON_DELETE_ALL	모두 삭제
MSI_RODEX_MESSAGE_DELETE_ALL	[%s]편지함의 모든 메일을 삭제하시겠습니까?
MSI_RODEX_BUTTON_RECEIVE_SELECTED	선택 받기
MSI_RODEX_BUTTON_RECEIVE_ALL	모두 받기
MSI_RODEX_MESSAGE_RECEIVE_SELECTED	선택한 메일의 첨부 물품을 받으시겠습니까?
MSI_RODEX_MESSAGE_RECEIVE_ALL	[%s]편지함의 모든 첨부 물품을 받으시겠습니까?
MSI_HOTKEYWND_SKILLBAR2	스킬바2
MSI_CHANGE_SKILLBER	스킬바 교체
MSI_HOTKEYGUIDEWND_LEFT	←
MSI_HOTKEYGUIDEWND_UP	↑
MSI_HOTKEYGUIDEWND_RIGHT	→
MSI_HOTKEYGUIDEWND_DOWN	↓
MSI_HOTKEYGUIDEWND_APPS	▤
MSI_HOTKEYGUIDEWND_BACK	←
MSI_WARNINGMSG_LOADING	로딩중에는 창을 닫을 수 없습니다.
MSI_USESKILL_FAIL_SPELLBOOK_NONE	리딩 스펠북으로 저장된 마법이 없습니다.
MSI_USE_WORLDMAP_WITH_PERIOD_MSG1	이동 시 사용한 아이템은 재교환이 불가능합니다.
MSI_USE_WORLDMAP_WITH_PERIOD_MSG2	자유이동권을 구매 하였습니다
MSI_USE_WORLDMAP_WITH_PERIOD_MSG3	자유이동권 사용 중, 관련 아이템을 소모하지 않습니다.
MSI_BTN_MESSAGE_APPLY	적용
MSI_BTN_MESSAGE_STOP	중지
MSI_USE_WORLDMAP_WITH_PERIOD_MSG4	자유이동권
MSI_USE_WORLDMAP_WITH_PERIOD_MSG5	%d시간 이용, %s %d개
MSI_USE_WORLDMAP_WITH_PERIOD_MSG6	자유이용권 사용중
MSI_ADVANCED_STATUS	특성 스테이터스
MSI_DESC_POW	파워 파라메터\n^cc0000물리 공격력, 특성 물리 공격력^ffffff 증가
MSI_DESC_STA	스테미나 파라메터\n^cc0000물리 저항력^ffffff 증가
MSI_DESC_WIS	위즈덤 파라메터\n^cc0000마법 저항력^ffffff 증가
MSI_DESC_SPL	스펠 파라메터\n^cc0000마법 공격력, 특성 마법 공격력^ffffff 증가
MSI_DESC_CON	컨센트레이션 파라메터\n^cc0000명중률, 회피율, 특성 물리/마법 공격력^ffffff 증가
MSI_DESC_CRT	크리에이티브 파라메터\n^cc0000특성 힐 회복량, 크리티컬 데미지 비율^ffffff 증가
MSI_DESC_ADV_STATUS_POWER_ATK	특성 물리 공격력
MSI_DESC_ADV_STATUS_SPELL_MATK	특성 마법 공격력
MSI_DESC_ADV_STATUS_STAMINA_RESIST	물리 저항력
MSI_DESC_ADV_STATUS_WISDOM_MRESIST	마법 저항력
MSI_DESC_ADV_STATUS_CREATIVE_HEALPULS	특성 힐 회복량
MSI_DESC_ADV_STATUS_CREATIVE_CRIDAMAGE_RATE	크리티컬 데미지 비율
MSI_DESC_ADV_POINT	특성 파라메터 레벨업에 사용되는 포인트
MSI_BASICINFO_JOBLEVEL2	J.Lv
MSI_BASICINFO_AP	AP
MSI_GUILD_AGIT_MOVE_AGIT	영지로 이동
MSI_GUILD_AGIT_INVESTMENT_INFO	상업도/방어도 확인
MSI_GUILD_AGIT_ARE_YOU_MOVE_AGIT	관리영지 \"%s\"(으)로 이동하시겠습니까?\n이동 시 마다 %d제니가 소모됩니다.\n(공성전 시간에는 %d제니가 소모됩니다.)
MSI_GUILD_AGIT_SHOW_INVESTMENT_INFO	\n관리영지 \"%s\"\n\t\n방어도: %d / %d\n상업도: %d / %d
MSI_GUILD_AGIT_MOVE_FAIL_MAP	공성 영지에서는 사용할 수 없는 기능입니다.
MSI_NOT_LEARN_BASIC_SKILL	기본 기능 스킬을 습득하지 않은 캐릭터입니다.
MSI_BAN_IP_BLOCK_FOR_ZERO	접속하신 IP는 라그나로크 제로 이용이 불가능합니다.\n고객센터 또는 홈페이지로 문의해 주십시오.
MSI_TOOLTIP_OF_OPTIONOFF_BTN	탑승/장착 해제
MSI_MCSTORE_BACKUP	가져오기
MSI_MCSTORE_BACKUP_TOOLTIP	직전 노점에 등록된 아이템 정보를 가져옵니다.
MSI_BAN_LOGIN_IS_RESTRICTED	서버 이슈로 인해 로그인이 제한되고 있습니다.
MSI_GUILD_AGIT_AGIT_MESSAGE	메시지
MSI_WARNING_UNDER_AGE_MSG1	+18 이상만 플레이가 가능합니다.
MSI_WARNING_UNDER_AGE_MSG2	3시간 이상의 게임 플레이를 권장하지 않습니다.
MSI_USESKILL_FAIL_AP_INSUFFICIENT	AP가 부족합니다.
MSI_LAPINE_FAIL_REFINING_LEVEL_OVERFLOW_NEEDED	제련도가 높아서 조합할 수 없습니다.
MSI_LAPINE_WARNING_REFINING_LEVEL_HIGHER_THAN_NEEDED	제련도가 조합에 필요한 요구치보다 높습니다.
MSI_LAPINE_WARNING_HAS_CARD_OR_ENCHANTED	카드가 끼워져있거나 인챈트 되어 있습니다.
MSI_ITEM_COUNT_INFINITY	∞
MSI_ITEMSHOP_CURRENCY	Z
MSI_PURCHASEWND_TOTAL	Total : %s Zeny
MSI_ACCOUNT_LIMITED_TOOL_TITLE	계정한정판매 등록창
MSI_ACCOUNT_LIMITED_DB_NAME	아이템 DB명
MSI_ACCOUNT_LIMITED_TOOL_DB_NUMBER	아이템 DB번호
MSI_ACCOUNT_LIMITED_TOOL_SELL_COUNT	판매 갯수
MSI_ACCOUNT_LIMITED_TOOL_SELL_STARTTIME	판매 시작시간
MSI_ACCOUNT_LIMITED_TOOL_SELL_ENDTIME	판매 종료시간
MSI_ACCOUNT_LIMITED_SALE_ITEM	계정 한정
MSI_ACCOUNT_LIMITED_SALE_ITEM_START_DATE	판매기간 : %d월 %d일 %d시 %d분
MSI_ACCOUNT_LIMITED_SALE_ITEM_NUM	계정당 구매가능
MSI_ACCOUNT_LIMITED_SALE_ITEM_LIMIT_NUM	%d개 한정
MSI_ACCOUNT_LIMITED_TOOL_RESULT_FORMAT	>> ItemName : %s /  수량 : %d / 판매기간 : %d월:%d일:%d시:%d분 ~ %d월:%d일:%d시:%d분
MSI_ACCOUNT_LIMITED_SALE_ITEM_SOLD_OUT	Sold Out
MSI_MAP_PROPERTY_DISABLE_CALLED	[%s]은(는) 현재 소환할 수 없는 지역에 있습니다.
MSI_ACCOUNT_LIMITED_SALE_ITEM_NEXT_DATE	~ %d월 %d일 %d시 %d분
MSI_ACCOUNT_LIMITED_SALE_ITEM_DONT_MOVE_CART	상품을 더이상 추가할 수 없습니다
MSI_CANNOT_EXCHANGE_ITEMS	장착 중인 아이템은 교환할 수 없습니다. 장착을 해제한 뒤 시도해 주시길 바랍니다.
MSI_QUIT_EXIT_AFTER_GUILD_CLOSE	길드 창고 이용 중엔 캐릭터 선택창으로 이동 할 수 없습니다.
MSI_HAVE_ITEMTAG	아이템 태그가 포함되어 있어 사용할 수 없습니다.
MSI_MONSTER_MONSTERINFO	Monster
MSI_UNKNOWN_MONSTERINFO	Unknown
MSI_UNDEAD_MONSTERINFO	Undead
MSI_ANIMAL_MONSTERINFO	Animal
MSI_PLANT_MONSTERINFO	Plant
MSI_INSECT_MONSTERINFO	Insect
MSI_MARINE_MONSTERINFO	Marine
MSI_DEVIL_MONSTERINFO	Devil
MSI_HUMAN_MONSTERINFO	Human
MSI_ANGEL_MONSTERINFO	Angel
MSI_DRAGON_MONSTERINFO	Dragon
MSI_NC_CASH_INNOVA	Balance: %s %c
MSI_BUY_RECONFIRM_CASHSTRINGFMT	 ^ff0000본 아이템을 구매 후 7일 이내에는 청약 철회가 가능합니다. 다만, 7일이 지났거나 아이템을 개봉하시면 청약 철회 대상에서 제외 됩니다.또한 구매시 사용된 무료캐시는 청약철회시 반환되지 않습니다.^000000 정말로 아이템을 구매하시겠습니까? 구매하실 경우 %s캐시가 차감됩니다.
MSI_BUY_RECONFIRM2_CASHSTRINGFMT	 ^ff0000본 아이템을 구매 후 7일 이내에는 청약 철회가 가능합니다. 다만, 7일이 지났거나 아이템을 개봉하시면 청약 철회 대상에서 제외 됩니다.또한 구매시 사용된 무료캐시는 청약철회시 반환되지 않습니다.^000000 정말로 아이템을 구매하시겠습니까? 구매하실 경우 일반 %s캐시, 무료 %s캐시가 차감됩니다.
MSI_CALL_REJECTED	호출이 거부되었습니다.
MSI_BUYINGSTORE_MAKEWND_LIMITZENY_NOT_OVER_MYMONEY	구매 한도액은 소지액을 초과할 수 없습니다.
MSI_BUYINGSTORE_MAKEWND_FAIL_CLOSE_UI	노점을 여는데 실패하였습니다. 구매노점 개설을 닫아주시기 바랍니다.
MSI_SAVE_SELL_STORE_ITEMLIST	판매 노점 아이템 리스트가 저장되었습니다.
MSI_SAVE_BUY_STORE_ITEMLIST	구매 노점 아이템 리스트가 저장되었습니다.
MSI_REFUSE_VTC_AUTH_FAILED	VTC 인증에 실패하였습니다.
MSI_EQUIP_FAIL_DURING_BARTER	물물교환 중에는 장비를 착용할 수 없습니다.
MSI_BARTER_ITEMLIST	교환하려는 품목
MSI_UPGRADESKILLERROR_MORE_THIRDJOBSKILL	 1차, 2차, 3차 직업 스킬 %d개를 더 올려 주십시오.
MSI_LIMIT_HAVE_ITEM_CNT	같은 아이템은 %d개까지 소유할 수 있습니다.
MSI_EXCHANGE_ITEM_CNT	같은 아이템은 한 번에 %d개까지 교환할 수 있습니다.
MSI_GLOBALRODEX_NOT_ABLE_TO_OPEN_MAIL_IN_CUR_SERVER	해당 로덱스는 \"%s\"서버에서 열 수 있습니다.
MSI_GLOBALRODEX_MESSAGE_DELETE_ALL_ON_ADMIN	[공지]편지함의 모든 메일을 삭제하시겠습니까 ? \n(해당 \"%s\"서버의 메일만 삭제됩니다.)
MSI_GLOBALRODEX_MESSAGE_RECEIVE_ALL	[공지]편지함의 모든 첨부 물품을 받으시겠습니까? \n(해당 \"%s\"서버의 메일의 물품만 받으실 수 있습니다.)
MSI_GLOBALRODEX_REFUSE_DELETING	해당 메일은 \"%s\"서버에서만 삭제 가능합니다.
MSI_GLOBALRODEX_REFUSE_RECEIVING	해당 메일은 \"%s\"서버에서만 물품 받기가 가능합니다.
MSI_GLOBALRODEX_REFUSE_READING	해당 메일은 \"%s\"서버에서만 내용읽기가 가능합니다.
MSI_TOTAL_NEED_MONEY	합계 : %d z
MSI_NORMAL_MESSAGEBOX_CAPTION	메세지
MSI_RESTRICT_OPENING_BUYINGSTORE_FAIL_OPEN_BUYINGSTORE	구매상점 개설 중에는 개인상점의 물건을 구입할 수 없습니다.
MSI_ITEM_GRADE_ENCHANT_SUCCEESS	등급강화가 성공적으로 되었습니다.
MSI_ITEM_GRADE_ENCHANT_FAIL	등급강화가 실패하였습니다.
MSI_ITEM_GRADE_ENCHANT_FAIL_DOWNGRADE	등급 수치가 하향 조정 되었습니다.
MSI_ITEM_GRADE_ENCHANT_FAIL_BREAK	장비가 파괴되었습니다.
MSI_ITEM_GRADE_ENCHANT_FAIL_PROTECT	장비가 보호되었습니다.
MSI_GRADE_ENCHANT_SOURCE_NOT_SELECT	재료가 선택되지 않았습니다.
MSI_GRADE_ENCHANT_SOURCE_ENOUGH	재료가 부족합니다.
MSI_GRADE_ENCHANT_MONEY_ENOUGH	소지 금액이 부족합니다.
MSI_GRADE_ENCHANT_INVENTORY_ENOUGH	아이템 공간이 부족합니다.
MSI_GRADE_ENCHANT_ITEM_PROTECT	장비가 보호되고 있습니다.
MSI_GRADE_ENCHANT_ITEM_NOT_PROTECT	장비가 파괴될 수 있습니다.
MSI_GRADE_ENCHANT_ITEM_DOWNGRADE	등급강화 실패 시 등급이 내려갑니다.
MSI_CLOSE_RODEX_FOR_GRADE_ENCHANT	등급강화 중에는 로덱스를 사용할 수 없습니다. 로덱스를 강제 종료하였습니다.
MSI_CANNOT_OPEN_RODEX_DURING_GRADE_ENCHANT	등급강화 중에는 로덱스를 사용할 수 없습니다.
MSI_CLOSE_BANKING_FOR_GRADE_ENCHANT	등급강화 중에는 은행을 사용할 수 없습니다. 은행을 강제 종료하였습니다.
MSI_CANNOT_OPEN_BANKING_DURING_GRADE_ENCHANT	등급강화 중에는 은행을 사용할 수 없습니다.
MSI_BROADCASTING_GRADE_ENCHANT_SUCCESS	[%s] 님이 등급강화를 성공하여, [%s등급 %s] 아이템을 획득하였습니다.
MSI_BROADCASTING_GRADE_ENCHANT_FAIL	[%s] 님이 [%s등급 %s] 아이템의 등급강화에 실패하였습니다.
MSI_CANNOT_GRADE_ENCHANT_ITEM	등급 강화가 불가능한 장비입니다.
MSI_CHANGE_MATERIAL	체인지 메테리얼
MSI_CHANGE_MATERIAL_SORT	가나다 정렬
MSI_CHANGE_MATERIAL_MESSAGE	※[%s] %d~%d개 제작
MSI_CHANGE_MATERIAL_SUCCESS_RATE	%d%%
MSI_MSG_IS_ILLEGAL_TAG_MSG	아이템 태그는 소지한 아이템만 태그할 수 있습니다.
MSI_IQ_POWERFUL_FAITH_ON	공격력 및 특성 공격력이 증가되었습니다.
MSI_IQ_POWERFUL_FAITH_OFF	강인한 신념 효과가 해제되었습니다.
MSI_IQ_FIRM_FAITH_ON	HP 및 물리 저항력이 증가되었습니다.
MSI_IQ_FIRM_FAITH_OFF	굳건한 신념 효과가 해제되었습니다.
MSI_IQ_SINCERE_FAITH_ON	공격 속도 및 유도 공격 확률이 증가되었습니다.
MSI_IQ_SINCERE_FAITH_OFF	신실한 신념 효과가 해제되었습니다.
MSI_CD_BENEDICTUM_ON	POW, CRT 및 CON 이 증가되었습니다.
MSI_CD_BENEDICTUM_OFF	베네딕툼 효과가 해제되었습니다.
MSI_CD_RELIGIO_ON	SPL, WIS 및 CRT 가 증가되었습니다.
MSI_CD_RELIGIO_OFF	렐리지오 효과가 해제되었습니다.
MSI_CD_COMPETENTIA_ON	특성 공격력 및 특성 마법 공격력이 증가되었습니다.
MSI_CD_COMPETENTIA_OFF	콤페텐티아 효과가 해제되었습니다.
MSI_CD_PRESENS_ACIES_ON	크리티컬 데미지 비율이 증가되었습니다.
MSI_CD_PRESENS_ACIES_OFF	프레센스 아치에스 효과가 해제되었습니다.
MSI_CD_ARGUTUS_TELUM_ON	물리 저항력 무시 효과가 부여되었습니다.
MSI_CD_ARGUTUS_TELUM_OFF	아르구투스 텔룸 효과가 해제되었습니다.
MSI_CD_ARGUTUS_VITA_ON	마법 저항력 무시 효과가 부여되었습니다.
MSI_CD_ARGUTUS_VITA_OFF	아르구투스 비타 효과가 해제되었습니다.
MSI_ITEMNUM_AND_WEIGHT	Num: %d/%d Weight: %d/%d
MSI_DK_SERVANTWEAPON_OFF	서번트 웨폰 효과가 해제되었습니다.
MSI_DK_CHARGINGPIERCE_OFF	챠징 피어스 효과가 해제되었습니다.
MSI_DK_VIGOR_OFF	비고르 효과가 해제되었습니다.
MSI_IG_ATTACK_STANCE_ON	공격력이 증가하고, 방어력이 감소되었습니다.
MSI_IG_ATTACK_STANCE_OFF	어택 스탠스 효과가 해제되었습니다.
MSI_IG_GUARD_STANCE_ON	방어력이 증가하고, 공격력이 감소되었습니다.
MSI_IG_GUARD_STANCE_OFF	가드 스탠스 효과가 해제되었습니다.
MSI_IG_GUARDIAN_SHIELD_ON	배리어가 부여되었습니다.
MSI_IG_GUARDIAN_SHIELD_OFF	가디언 쉴드 효과가 해제되었습니다.
MSI_IG_REBOUND_SHIELD_ON	헌신 효과로 받는 데미지가 감소되었습니다.
MSI_IG_REBOUND_SHIELD_OFF	리바운드 쉴드 효과가 해제되었습니다.
MSI_IG_HOLY_SHIELD_ON	성속성 마법 데미지와 암/불사속성 내성이 증가되었습니다. 
MSI_IG_HOLY_SHIELD_OFF	홀리 쉴드 효과가 해제되었습니다.
MSI_IG_ULTIMATE_SACRIFICE_ON	즉시 부활 효과가 부여되었습니다.
MSI_IG_ULTIMATE_SACRIFICE_OFF	얼티메이트 세크리파이스 효과가 해제되었습니다.
MSI_AG_CLIMAX_ON	특정 스킬의 효능이 변경되었습니다.
MSI_AG_CLIMAX_OFF	클라이막스 효과가 해제되었습니다.
MSI_SHC_SHADOW_EXCEED_ON	특정 스킬의 효능이 변경되었습니다.
MSI_SHC_SHADOW_EXCEED_OFF	쉐도우 익시드 효과가 해제되었습니다.
MSI_SHC_POTENT_VENOM_ON	물리 저항력 무시 효과가 부여되었습니다.
MSI_SHC_POTENT_VENOM_OFF	포텐트 베넘 효과가 해제되었습니다.
MSI_SHC_ENCHANTING_SHADOW_ON	매 공격 시, 일정 확률로 대상이 받는 데미지를 증가시킵니다.
MSI_SHC_ENCHANTING_SHADOW_OFF	인챈팅 쉐도우 효과가 해제되었습니다.
MSI_HUNTING_QUEST_INFO_ON	토벌 카운트 On
MSI_HUNTING_QUEST_INFO_OFF	토벌 카운트 Off
MSI_TARGET_AP_MAX	대상의 AP가 최대치입니다
MSI_BUY_RECONFIRM1_2019	^ff0000본 아이템을 구매 후 7일 이내에는 청약 철회가 가능합니다. 다만, 7일이 지났거나 아이템을 개봉하시면 청약 철회 대상에서 제외 됩니다.또한 구매시 사용된 무료캐시는 청약철회시 반환되지 않습니다.일부(이벤트) 아이템의 경우 이벤트 종료 시 삭제될 수 있으며, 아이템 설명 내 기재된 삭제기간을 확인해 주시기 바랍니다.^000000 정말로 아이템을 구매하시겠습니까? 구매하실 경우 %d캐시가 차감됩니다.
MSI_BUY_RECONFIRM2_2019	^ff0000본 아이템을 구매 후 7일 이내에는 청약 철회가 가능합니다. 다만, 7일이 지났거나 아이템을 개봉하시면 청약 철회 대상에서 제외 됩니다.또한 구매시 사용된 무료캐시는 청약철회시 반환되지 않습니다.일부(이벤트) 아이템의 경우 이벤트 종료 시 삭제될 수 있으며, 아이템 설명 내 기재된 삭제기간을 확인해 주시기 바랍니다.^000000 정말로 아이템을 구매하시겠습니까? 구매하실 경우 일반 %d캐시, 무료 %d캐시가 차감됩니다.
MSI_FAIL_EMPTY_SERVANTWEAPON	서번트 웨폰 %d개가 필요합니다.
MSI_BILLING_INFO_URL	https://member.gnjoy.com.tw/billing.aspx
MSI_CHANGE_MATERIAL_INVSORT	역순 정렬
MSI_CHANGE_MATERIAL_SEARCHTEXT	검색 내용 입력
MSI_SEARCH	검색
MSI_BO_RESEARCHREPORT_ON	리서치 리포트 상태가 됩니다.
MSI_BO_RESEARCHREPORT_OFF	리서치 리포트 상태가 해제됩니다.
MSI_BO_BIONIC_PHARMACY_OK	제조에 성공 했습니다.
MSI_BO_BIONIC_PHARMACY_FAIL	제조에 실패 했습니다.
MSI_BO_ADVANCE_PROTECTION_ON	쉐도우 장비가 파괴 및 해제에서 보호됩니다.
MSI_BO_ADVANCE_PROTECTION_OFF	풀 쉐도우 프로텍션이 해제됩니다.
MSI_BO_HELLTREE_ON	식물형, 무형 몬스터에게 주는 데미지가 증가합니다.
MSI_BO_HELLTREE_OFF	지옥 나무의 가루효과가 사라집니다.
MSI_MT_A_MACHINE_ON	공격 장치가 활성화되었습니다.
MSI_MT_A_MACHINE_OFF	공격 장치가 해제되었습니다.
MSI_MT_D_MACHINE_ON	물리 방어력 및 물리 저항력이 증가되었습니다.
MSI_MT_D_MACHINE_OFF	방어 장치가 해제되었습니다.
MSI_CASHSHOP_TAB_SEARCH	검색
MSI_TR_KVASIR_SONATA_ON	합주를 혼자 사용할 수 있습니다.
MSI_TR_KVASIR_SONATA_OFF	크바시르의 지혜가 사라집니다.
MSI_TR_MYSTIC_SYMPHONY_ON	미스틱 심포니의 효과가 부여됩니다.
MSI_TR_MYSTIC_SYMPHONY_OFF	미스틱 심포니의 효과가 사라집니다.
MSI_TR_GEF_NOCTURN_ON	마법 저항력이 감소했습니다.
MSI_TR_GEF_NOCTURN_OFF	게페니아 녹턴의 효과가 해제 되었습니다.
MSI_TR_AIN_RHAPSODY_ON	물리 저항력이 감소했습니다.
MSI_TR_AIN_RHAPSODY_OFF	마인워커 랩소디 상태가 해제되었습니다.
MSI_TR_MUSICAL_INTERLUDE_ON	물리 저항력이 증가했습니다.
MSI_TR_MUSICAL_INTERLUDE_OFF	뮤지컬 인터루드 상태가 해제되었습니다.
MSI_TR_JAWAII_SERENADE_ON	특성 마법 공격력과 이동 속도가 증가합니다.
MSI_TR_JAWAII_SERENADE_OFF	저녁 노을의 세레나데 효과가 해제되었습니다.
MSI_TR_PRON_MARCH_ON	특성 물리 공격력과 이동 속도가 증가합니다.
MSI_TR_PRON_MARCH_OFF	 프론테라의 행진곡 효과가 해제되었습니다.
MSI_WH_CALAMITYGALE_ON	바람의 분노가 시전자에게 흘러 들어옵니다.
MSI_WH_CALAMITYGALE_OFF	캘러미티 가일 상태가 해제되었습니다.
MSI_WH_WIND_SIGN_ON	바람에 의해 약점과 모습이 드러납니다.
MSI_WH_WIND_SIGN_OFF	윈드 사인 효과가 사라집니다.
MSI_THAI_PERSONALINFO_EXP2	E X P : %.1f%% ( basic 100.0%% %s %.1f%%)
MSI_THAI_PERSONALINFO_DROP2	DROP  : %.1f%% ( basic 100.0%% %s %.1f%%)
MSI_THAI_PERSONALINFO_DEATH2	DEATH : %.1f%% ( basic 100.0%% %s %.1f%%)
MSI_EM_SPELL_ENCHANTING_ON	특성 마법 공격력이 증가되었습니다.
MSI_EM_SPELL_ENCHANTING_OFF	스펠 인챈팅 효과가 해제되었습니다.
MSI_ABC_FROM_THE_ABYSS_OFF	프롬 디 어비스 효과가 해제되었습니다.
MSI_ABC_ABYSS_SLAYER_ON	특성 물리 공격력, 특성 마법 공격력 및 명중률이 증가되었습니다.
MSI_ABC_ABYSS_SLAYER_OFF	어비스 슬레이어 효과가 해제되었습니다.
MSI_CHARACTER_MAKING_RESTRICT	캐릭터 생성에 제한이 있을 수 있습니다.
MSI_BAN_THAI_GGT_RESTRICTED_MAKE_CHAR	월드가 포화상태입니다. 다른 월드를 이용해 주세요.
MSI_UNBLOCK_CHAT	채팅차단해제(수신거부해제)
MSI_BLOCK_CHAT	채팅차단(수신거부)
MSI_GRADE_ENCHANT_REFINING_LEVEL_LACK	해당 제련도는 등급 강화가 불가능합니다.
MSI_GRADE_ENCHANT_ITEM_UNBREAKABLE	장비가 파괴되지 않는 상태입니다.
MSI_GRADE_ENCHANT_ADDITIONAL_SOURCE_NOT_SELECT	보조 재료가 적용되어 있지 않습니다. \n강화를 계속 진행 하시겠습니까?
MSI_CHEAT_HASHFILE	클라이언트 파일이 변조되었습니다.
MSI_GUILD_AGIT_TITLE	메시지
MSI_MERCHANTSHOP_TOTA_LOVER_ZENY_ERR	판매할 물품의 총합이 가질 수 있는 Zeny의 양을 넘습니다.\n수량 및 가격 조정을 부탁드립니다.
MSI_REPUTE_WND	평판 현황
MSI_REPUTE_POINT	%u / 1000 P
MSI_REPUTE_TOTAL	전체
MSI_REPUTE_NOW_LOADING	NOW LOADING..
MSI_GRADE_ENCHANT_ADDITIONAL_SOURCE_RESET	보조 재료 선택이 초기화 됩니다.
MSI_ENCHANT	
MSI_ENCHANT_TAB_GENERAL	일반
MSI_ENCHANT_TAB_PERFECT	확정
MSI_ENCHANT_TAB_UPGRADE	성장
MSI_ENCHANT_TAB_RESET	초기화
MSI_ENCHANT_FAILED_OVER_WEIGHT	무게가 70% 이상입니다. 무게를 줄인 후 재시도 해주세요.
MSI_ENCHANT_RANDOM_BUTTON	인챈트 부여
MSI_ENCHANT_PERFECT_BUTTON	인챈트 부여
MSI_ENCHANT_UPGRADE_BUTTON	성장
MSI_ENCHANT_RESET_BUTTON	초기화
MSI_CLOSE_RODEX_FOR_ENCHANT	인챈트 중에는 로덱스를 사용할 수 없습니다. 로덱스를 강제 종료하였습니다.
MSI_CANNOT_OPEN_RODEX_DURING_ENCHANT	인챈트 중에는 로덱스를 사용할 수 없습니다.
MSI_CLOSE_BANKING_FOR_ENCHANT	인챈트 중에는 은행을 사용할 수 없습니다. 은행을 강제 종료하였습니다.
MSI_CANNOT_OPEN_BANKING_DURING_ENCHANT	인챈트 중에는 은행을 사용할 수 없습니다.
MSI_ENCHANT_REQUEST	인챈트를 실행하시겠습니까?
MSI_ITEM_REFORM_OK	제작
MSI_ITEM_REFORM_WARNNING_NOT_ENOUGH_MATERIAL	조합에 필요한 재료가 부족합니다.
MSI_ITEM_REFORM_WARNNING_CARD_ENCHANT_LOST	장착된 카드 아이템과 부여된 인챈트가 소실됩니다.
MSI_ITEM_REFORM_WARNNING_CARD_MAYBE_LOST	장착된 카드 아이템이 소실될 수 있습니다.
MSI_ITEM_REFORM_WARNNING_ENCHANT_MAYBE_LOST	부여된 인챈트가 소실될 수 있습니다.
MSI_HIDE_PLAYER_ON	화면 내 유저 숨기기 ON
MSI_HIDE_PLAYER_OFF	화면 내 유저 숨기기 OFF
MSI_ITEM_REFORM_CONFIRM_DETAILS	세부 내용 확인
MSI_ITEM_REFORM_PLZ_CHECK_DETAILS	세부 내용을 확인해주세요.
MSI_ITEM_REFORM_NO_EXIST_TARGET_ITEM	조합 가능한 아이템이 없습니다.
MSI_ENCHANT_SUCCESS	인챈트 성공!
MSI_ENCHANT_FAILED	인챈트 실패!
MSI_CANNOT_FIND_ENCHANT_ID	인챈트 정보를 찾을 수 없습니다
MSI_NOT_SATISFIED_ENCHANT_CONDITION	인챈트 조건을 만족하지 않습니다.
MSI_RODEX_SPAMOPTION_FAIL	임의 유저 수신 여부 설정 실패.
MSI_RODEX_SPAMOPTION_ON	임의 유저 수신 거부 상태로 설정 되었습니다.
MSI_RODEX_SPAMOPTION_OFF	모든 유저 수신 상태로 설정 되었습니다.
MSI_RODEX_SPAMOPTION_USERBLOCK	%s님이 수신 거부 상태 입니다.
MSI_RODEX_SPAMOPTION_RETURN_SUCCESS	RODEX가 반송 되었습니다.
MSI_RODEX_SPAMOPTION_RETURN_FAIL	RODEX 반송에 실패 하였습니다.
MSI_RODEX_SPAMOPTION_WARNING	해당 RODEX의 발신자는 친구 및 길드원이 아닙니다.주의 해주세요.
MSI_RODEX_SPAMOPTION	RODEX 모든 유저 수신
MSI_EFST_ITEM_TIME_LIMIT_EXCEED	동일한 효과의 지속 시간이 한도를 초과하여 사용이 불가능합니다.
MSI_GRADE_ENCHANT_SUCCESS_REFINING_LEVEL_DISAPPEAR	성공 시 제련도는 0으로 초기화됩니다!
MSI_GRADE_ENCHANT_SUCCESS_RANDOM_OPT_ENCHANT_KEEP	카드, 랜덤옵션, 인챈트는 유지됩니다.
MSI_GRADE_ENCHANT_FAILED_REFINING_RANDOM_OPT_ENCHANT_KEEP	실패 시 제련도는 유지됩니다.
MSI_HOTKEY_RESET	초기화
MSI_HOTKEY_OLD_VER	구버전
MSI_EXP_BAR_BASE_LV	Base Lv. %d
MSI_EXP_BAR_JOB_LV	Job Lv. %d
MSI_BASIC_INFO_LV_NAME	Lv.%d %s
MSI_MENU_ICON_QUEST	퀘스트목록
MSI_MENU_ICON_CASHSHOP	캐시상점
MSI_MENU_ICON_HOTKEY	단축키안내
MSI_MENU_ICON_ADVENTURER_AGENCY	모험가중개소
MSI_NEWUI_ZERO_ONOFF	UI 테마
MSI_NEWUI_ZERO_UIOLD	기존 UI
MSI_NEWUI_ZERO_UINEW	신규 UI
MSI_NEWUI_ZERO_UISKIN	UI 스킨
MSI_NEW_RANDOM_OPTION	- 추가 옵션 -
MSI_MONSTERINFO_TRIBE_UNKNOWN	무형
MSI_MONSTERINFO_TRIBE_UNDEAD	불사형
MSI_MONSTERINFO_TRIBE_ANIMAL	동물형
MSI_MONSTERINFO_TRIBE_PLANT	식물형
MSI_MONSTERINFO_TRIBE_INSECT	곤충형
MSI_MONSTERINFO_TRIBE_MARINE	어패형
MSI_MONSTERINFO_TRIBE_DEVIL	악마형
MSI_MONSTERINFO_TRIBE_HUMAN	인간형
MSI_MONSTERINFO_TRIBE_ANGEL	천사형
MSI_MONSTERINFO_TRIBE_DRAGON	용족
MSI_MONSTERINFO_PROPERTY_NEUTURAL	무
MSI_MONSTERINFO_PROPERTY_WATER	수
MSI_MONSTERINFO_PROPERTY_EARTH	지
MSI_MONSTERINFO_PROPERTY_FIRE	화
MSI_MONSTERINFO_PROPERTY_WIND	풍
MSI_MONSTERINFO_PROPERTY_POISON	독
MSI_MONSTERINFO_PROPERTY_SAINT	성
MSI_MONSTERINFO_PROPERTY_DARK	암
MSI_MONSTERINFO_PROPERTY_MENTAL	염
MSI_MONSTERINFO_PROPERTY_UNDEAD	불사
MSI_MONSTERINFO_SIZE_SMALL	소형
MSI_MONSTERINFO_SIZE_MIDDLE	중형
MSI_MONSTERINFO_SIZE_BIG	대형
MSI_MONSTERINFO_DEF	DEF
MSI_BAN_TEENAGER	청소년은 접속이 제한되어 있습니다.
MSI_STYLINGSHOP_COLOR_RESET	0Zeny (염색제거)
MSI_ZEROQUEST_ALLSELECT	모두 선택
MSI_ZEROQUEST_SIMPLEUI_ON	간편 퀘스트 UI
MSI_CASHSHOP_FREE	FREE!
MSI_ACCOUNT_LIMITED_TOOL_RENT_TIME	임대 기간
MSI_ACCOUNT_LIMITED_TOOL_RENT_TIME_MAX_14DAY	임대 기간은 최대 14일까지 입력 가능합니다.
MSI_CASHSHOP_NON_TRADABLE	거래 불가
MSI_ZEROQUEST_QUESTVIEWWND_ON	간편 퀘스트 보기
MSI_ZEROQUEST_QUESTVIEWWND_OFF	간편 퀘스트 숨김
MSI_ZEROQUEST_QUESTVIEW_ON	간편 퀘스트창에 추가
MSI_ZEROQUEST_QUESTVIEW_OFF	간편 퀘스트창에서 삭제
MSI_ZEROQUEST_QUESTHELP_TITLE	퀘스트 도움말
MSI_ZEROQUEST_QUESTHELP_1	1. 콤보박스 + 검색어 입력창 : 퀘스트 정렬, 검색 기능
MSI_ZEROQUEST_QUESTHELP_2	- ALL : 받은 퀘스트 전체보기
MSI_ZEROQUEST_QUESTHELP_3	- 퀘스트 종류 : NORMAL(노멀)/ MAIN(메인)/ EPISODE(에피소드)/ DAILY(일일)/ LOCAL(지역)/ JOB(직업)/ GUIDE(가이드)/ EVENT(이벤트) 퀘스트로 분류하여 정렬합니다.
MSI_ZEROQUEST_QUESTHELP_4	- 콤보 박스로 정렬한 퀘스트 목록에서 원하는 내용을 좀 더 세분화하여 검색할 수 있습니다.
MSI_ZEROQUEST_QUESTHELP_5	2. 내비게이션 UI
MSI_ZEROQUEST_QUESTHELP_6	- 내비게이션 UI 열기 :
MSI_ZEROQUEST_QUESTHELP_7	메뉴아이콘 → 내비게이션 아이콘(단축키 : N)
MSI_ZEROQUEST_QUESTHELP_8	- 텍스트 하이퍼링크 또는 npc(몬스터) 이미지 클릭 : 
MSI_ZEROQUEST_QUESTHELP_9	내비게이션 경로 표시 & 필드 바닥에 목표 지점까지 발자국(화살표)표시
MSI_ZEROQUEST_QUESTHELP_10	3. 내비게이션 실행 시, 채팅창에 이동 경로가 안내 됩니다
MSI_ZEROQUEST_QUESTHELP_11	4. 카프라 직원과 대화하여[공간이동 서비스]를 이용할 수 있습니다.
MSI_ZEROQUEST_QUESTHELP_12	5. 간편 퀘스트 UI :
MSI_ZEROQUEST_QUESTHELP_13	퀘스트 UI를 게임 화면에 간단히 표시 해주는 기능
MSI_ZEROQUEST_QUESTHELP_14	각 퀘스트 제목 마우스 우클릭 시, 퀘스트정보 UI 호출 또는 해당 퀘스트 목록 내 삭제
MSI_ZEROQUEST_QUESTHELP_15	기능이 있습니다.
MSI_TIPBOX_START_OPEN	시작할 때 열기
MSI_RESULT_ERROR_VTC_303	결제정보 세션이 만료되었습니다. 클라이언트를 재실행 해주세요
MSI_RESULT_ERROR_VTC_304	오류가 발생했습니다. 다시 시도해 주세요
MSI_ZEROCHATWND_RESIZE	크기 변경(%s)
MSI_ZEROCHATWND_LOCK	기능 잠금
MSI_ZEROCHATWND_UNLOCK	기능 해제
MSI_ZEROCHATWND_CHATON	입력 활성
MSI_ZEROCHATWND_CHATOFF	입력 비활성
MSI_ZEROCHATWND_SEND	수신인 설정
MSI_ZEROCHATWND_SENDG	수신그룹 설정
MSI_ZEROCHATWND_OPTION	설정
MSI_ZEROCHATWND_STICKOFF	팝업창 분리
MSI_ZEROCHATWND_STICKON	탭으로 돌아가기
MSI_ZEROCHATWND_ADD	탭 추가
MSI_ZEROCHATWND_DEL	탭 삭제
MSI_ZEROCHATWND_ENTER	Enter키를 누르면 채팅을 시작할수 있습니다
MSI_TAKEOFF_ALL	장비해제
MSI_FAILED_BUSY	잠시 후 다시 시도해주세요.
MSI_USESKILL_FAIL_NEED_TWINKLING_GALAXY_AREA	천지만성 지역에서 사용가능합니다.
MSI_USESKILL_FAIL_NEED_SOULCOLLECT	영혼 축적 효과가 필요합니다.
MSI_USESKILL_FAIL_NEED_CHARMS	부적이 부족합니다.
MSI_USESKILL_FAIL_NEED_GATLING_OR_SHOTGUN	개틀링건 혹은 샷건 계열의 총기류를 장착한 상태여야 합니다.
MSI_USESKILL_FAIL_NEED_RIFLE_OR_HANDGUN	라이플 혹은 리볼버 계열의 총기류를 장착한 상태여야 합니다.
MSI_USESKILL_FAIL_NEED_GRANADE_OR_RIFLE	그레네이드 런처 혹은 라이플 계열의 총기류를 장착한 상태여야 합니다.
MSI_USESKILL_FAIL_NEED_GATLING_OR_HANDGUN	개틀링건 혹은 리볼버 계열의 총기류를 장착한 상태여야 합니다.
MSI_USESKILL_FAIL_NEED_SHOTGUN_OR_GRANADE	샷건 혹은 그레네이드 런처 계열의 총기류를 장착한 상태여야 합니다.
MSI_USESKILL_FAIL_NEED_SHIELD_WEAPON	장착한 방패가 없습니다.
MSI_CLOSE_BANKING_FOR_EXPANDED_BARTERMARKET	다중 물물 교환 중에는 은행을 사용할 수 없습니다. 은행을 강제 종료하였습니다.
MSI_CANNOT_OPEN_BANKING_DURING_EXPANDED_BARTERMARKET	다중 물물 교환 중에는 은행을 사용할 수 없습니다.
MSI_FAIL_NO_SPACE_BEHIND_THE_TARGET	대상의 그림자에 이동할 공간이 없습니다.
MSI_USESKILL_FAIL_NEED_COMMUNION_WITH_SPIRIT	최소한 한종의 영물과 교감하는 상태여야 합니다.
MSI_PACKAGEITEM_SLEEPSTONECURSEFAIL	수면, 석화 상태에서는 아이템을 사용 할 수 없습니다.
MSI_PACKAGEITEM_BURROWFAIL	Burrow 상태에서는 아이템을 사용 할 수 없습니다.
MSI_PACKAGEITEM_USEFAIL	패키지 아이템 사용 할 수 없는 상태 입니다.
MSI_PACKAGEITEM_SETTINGFAIL	패키지 아이템 셋팅 실패!!
MSI_PACKAGEITEM_TIME	^ff0000 %d일 %d시간 동안 사용 가능 ^000000
MSI_PACKAGEITEM_SELECT	%s(을)를 선택하셨습니다. 선택한 내용이 맞습니까?
MSI_GRADE_ENCHANT_ENHANCED_UP	1회당 요구 수량 : %d개
MSI_JOB_IMPERIAL_GUARD	Imperial Guard
MSI_JOB_ABYSS_CHASER	Abyss Chaser
MSI_JOB_WINDHAWK	Windhawk
MSI_EMBLEM_UPLOAD_FAILED_DB	엠블렘 등록에 실패하였습니다.
MSI_EMBLEM_UPLOAD_FAILED_AUTH	서버 등록에 실패하였습니다.
MSI_EMBLEM_UPLOAD_FAILED_FILE	파일 등록에 실패 하였습니다.
MSI_SORT_MINIPARTY	미니파티창 정렬
MSI_PICKUP_FAILED_PARTY_MEMBER	균등분배 상태입니다.\n파티원의 무게 또는 종류가 초과하여 아이템을 획득할 수 없습니다.
MSI_BROADCASTING_SPECIAL_ITEM_OBTAIN_ADD_LEVEL	[%s]님이 [%s](으)로부터 '+%d %s' 를 획득 했습니다.
MSI_FAILED_ALL_RODEX_LIST	우편함을 다시 열어주세요.
MSI_FAIL_CALLHOMUN_INVALID_JOBTYPE	현재의 직업에서는 호문클루스S를 소환할 수 없습니다. 상위 직업으로의 전직이 필요합니다.
MSI_FAIL_ITEMCOMPOSITION_LIST	카드를 장착할 수 있는 장비 아이템이 없습니다.
MSI_DAMAGE_EQUIPMENT	데미지 표시
MSI_DAMAGE_EQUIPMENT_TOOLTIP	데미지 표시
MSI_DAMAGE_DIR_LEFT	↖
MSI_DAMAGE_DIR_CENTER	↑
MSI_DAMAGE_DIR_RIGHT	↗
MSI_DAMAGE_DIR_DEFAULT	Default
MSI_MACRO_CHECK_REMOVE_RUNNING	이미 추적 중인 대상이 존재합니다.
MSI_MACRO_CHECK_REMOVE_SUCCESS	대상 추적을 시작합니다.
MSI_MACRO_CHECK_REMOVE_NOT_EXISTS	추적 중인 대상이 없습니다.
MSI_MACRO_CHECK_REMOVE_OFF_SUCCESS	추적을 종료합니다.
MSI_MACRO_CHECK_REMOVE_TIMESUP	시간이 만료되어 추적을 종료합니다.
MSI_MACRO_CHECK_REMOVE_INVALID_AID	대상을 찾을 수 없습니다.
MSI_NEWSEIGEMODE_SKILL	^0054FF[능력치보정] % d.%d %%^000000
MSI_DYNAMICNPC_CREATE_RESULT_FAIL_MAXCOUNT	더 이상 NPC를 호출할 수 없습니다.
MSI_MACRO_DETECTOR_NOTICE4	%d회 오류시 운영정책에 의거하여 영구블록됩니다.
MSI_FAIL_CALLHOMUN_OVER_100LEVEL	현재의 직업에서는 소환할 수 없습니다. 상위 직업으로의 전직이 필요합니다.
MSI_FAIL_STRIPSHADOW_TO_MADO_NOTICE	마도 기어 탑승자에게는 스트립 계열, 코팅 계열 스킬을 사용할 수 없습니다.
MSI_MACRO_REPORTER_SELECT_MODE_MAP	맵
MSI_MACRO_REPORTER_SELECT_MODE_QUIZ	퀴즈
MSI_MACRO_REPORTER_TOOLTIP_MAP	아래 텍스트 범위에 체커를 보낼 맵을 입력합니다.
MSI_MACRO_REPORTER_TOOLTIP_QUIZ	아래 텍스트 범위에 체커에 보여질 퀴즈를 입력합니다.
MSI_MACRO_REPORTER_UNKNWON_MAP	맵 파일명이 올바르지 않습니다.
MSI_MACRO_REPORTER_WRONG_NUMBER	숫자 조합이 올바르지 않습니다.
MSI_MACRO_REPORTER_TOOLTIP_MAP_QUIZ_INPUT	저장을 위해 작성 후 엔터를 입력해주세요.
MSI_MACRO_BLACKLIST_USER_CHCEK_RESULT_SUCCESS	블랙리스트 유저 %d명에게 체커를 보냈습니다.
MSI_MACRO_BLACKLIST_USER_CHCEK_RESULT_FAIL_COOLTIME	블랙리스트 체커 쿨타임입니다.
MSI_MACRO_BLACKLIST_USER_CHCEK_RESULT_FAIL_MAPNAME	Map 값에 문제가 있습니다.
MSI_MACRO_BLACKLIST_USER_CHCEK_RESULT_FAIL_PARAM	Quiz 또는 정답 횟수에 문제가 있습니다.
MSI_MACRO_BLACKLIST_USER_CHCEK_RESULT_FAIL_QUESTION	Quiz 값에 문제가 있습니다.
MSI_MACRO_BLACKLIST_USER_CHCEK_RESULT_FAIL_MAPNAME_COUNT	Map 갯수에 문제가 있습니다.
MSI_MACRO_BLACKLIST_USER_CHCEK_REMAIN_TIME	남은 시간 %02d : %02d : %02d
MSI_MACRO_BLACKLIST_USER_CHCEK_NOTICE1	탐지 모드가 발동 하였습니다. 화면 좌측에 표시된 숫자를 키패드로 입력하세요.
MSI_MACRO_BLACKLIST_USER_CHCEK_NOTICE2	남은 시간이 만료되거나 오답 %d회 시 패널티가 부여됩니다.
MSI_MACRO_BLACKLIST_USER_CHCEK_ANSWER_INPUT	보안 번호 입력
MSI_WEDDING_RING_ITEM_NAME_FORMAT	%s씨와의 
MSI_ACCOUNT_LIMITED_TOOL_RESULT_NEWFORMAT	>> ItemName : %s /  수량 : %d / 판매기간 : %d월:%d일:%d시:%d분 ~ %d년:%d월:%d일:%d시:%d분
MSI_ACCOUNT_LIMITED_SALE_ITEM_NEXT_NEWDATE	~ %d년 %d월 %d일 %d시 %d분
MSI_CANNOT_ATTACK_IN_THE_PARTYWND	파티창에서는 같은 파티원에게 공격스킬을 사용할 수 없습니다.
MSI_RETRY_AFTER_PROCESS	진행 또는 초대된 상태 완료 후 재시도 해주세요.
MSI_GUILD_EXP_TRIBUTE	상납 경험치 max 메세지 표시
MSI_EQUIPMENT_PROPERTIES	장비 능력치
MSI_VIEW_CHANGE_EQUIPMENT_PROPERTIES_MSG	장비 장착/해제시 능력치 변화 표시
MSI_ALLY_CHAT_MSG	동맹 채팅 메시지 표시
MSI_SEND_TO_ALLY	동맹에게 보냄
MSI_PAY_CONFIRM_BY_NYANGVINE_FRUIT	^FF2931사용된 냥다래 열매 아이템은\n청약철회 대상에 포함되지\n않으며, 냥다래 열매로의\n재교환 역시 불가능합니다.
MSI_REFINING_POSSIBLE	제련 가능
MSI_REFINING_IMPOSSIBLE	제련 불가
MSI_ENCHANT_POSSIBLE	인챈트 가능
MSI_ENCHANT_IMPOSSIBLE	인챈트 불가
MSI_GRADE_ENCHANT_POSSIBLE	등급 강화 가능
MSI_GRADE_ENCHANT_IMPOSSIBLE	등급 강화 불가
MSI_RUNESYSTEM_EQUIP_OUT	장착을 해제 하시겠습니까?
MSI_RUNESYSTEM_EQUIP_NOTPUT	선택된 항목에 정보가 잘못 되었습니다.
MSI_RUNESYSTEM_RUNESET_TITLE	룬 타블렛: %s 세트
MSI_RUNESYSTEM_RUNE_TITLE	%s의 룬 조각
MSI_RUNESYSTEM_RUNE_UPGRADEPER	강화 확률
MSI_RUNESYSTEM_RUNE_FAILDESC	실패시 성공확률이 %.2f%% 증가합니다.
MSI_RUNESYSTEM_RUNE_UPGRADEMAXDESC	최대 강화 등급입니다.
MSI_RUNESYSTEM_RUNE_UNACTIVEDESC	비활성화 상태에서 불가능한 기능입니다.
MSI_RUNESYSTEM_RUNE_RUNE_NULL	룬 정보가 존재 하지 않습니다.
MSI_RUNESYSTEM_RUNESET_DESC	%d 세트 효과
MSI_RUNESYSTEM_TITLE	룬 타블렛 시스템
MSI_RUNESYSTEM_EQUIP_NOT	장착된 룬이 없습니다.
MSI_RUNESYSTEM_EQUIP_PUTERR	장착된 룬 세트를 해제하여 주시기 바랍니다.
MSI_ADVENTURE_GUIDE	모험 가이드
MSI_RUNESYSTEM_DURING_CANNOT_OPEN_RODEX	룬시스템 사용 중에는 로덱스를 사용할 수 없습니다.
MSI_RUNESYSTEM_DURING_CANNOT_OPEN_BANKING	룬시스템 사용 중에는 뱅킹을 사용할 수 없습니다.
MSI_RUNESYSTEM_CLOSE_RODEX	룬시스템 사용 중에는 로덱스를 사용 할 수 없습니다. 로덱스를 강제 종료 하였습니다.
MSI_RUNESYSTEM_CLOSE_BANKING	룬시스템 사용 중에는 뱅킹을 사용 할 수 없습니다. 뱅킹을 강제 종료 하였습니다.
MSI_NOTIFY_JOIN_GUILD_ACCEPT_WND	길드 가입 요청이 있습니다. 이동 관련 창을 모두 종료한 뒤 요청 확인이 가능합니다.
MSI_NOTIFY_ALLY_GUILD_ACCEPT_WND	동맹 등록 요청이 있습니다. 이동 관련 창을 모두 종료한 뒤 요청 확인이 가능합니다.
MSI_NOTIFY_JOIN_FRIEND_ACCEPT_WND	친구 등록 요청이 있습니다. 이동 관련 창을 모두 종료한 뒤 요청 확인이 가능합니다.
MSI_NOTIFY_JOIN_PARTY_ACCEPT_WND	파티 가입 요청이 있습니다. 이동 관련 창을 모두 종료한 뒤 요청 확인이 가능합니다.
MSI_NOTIFY_EXCHANGE_ACCEPT_WND	1:1 거래 요청이 있습니다. 이동 관련 창을 모두 종료한 뒤 요청 확인이 가능합니다.
MSI_WARNING	경고
MSI_RUNESYSTEM_FAILED_ITEMCREATE	소지 한계량이 70%를 초과하거나, 인벤토리에 8칸 이상의 여유 공간이 부족한 상태입니다.
MSI_TITLE_QUEST_BOARD_LIST	퀘스트 보드
MSI_TITLE_QUEST_BOARD_INFO	퀘스트 정보
MSI_MACRO_USER_REPORT	유저 신고하기
MSI_MACRO_USER_REPORT_COUNTLIMIT	일일 신고 횟수를 초과하여 더 이상 신고할 수 없습니다.
MSI_MACRO_USER_REPORT_SUCCESS	%s님에 대한 신고 접수가 완료되었습니다. 깨끗한 게임 환경을 위하여 계속 노력하겠습니다.
MSI_MACRO_USER_REPORT_COOLTIME	대상은 다른 플레이어의 신고가 진행중입니다.
MSI_MACRO_USER_REPORT_EFST_ACTIVATED	대상은 신고에 보호중인 상태 입니다.
MSI_MACRO_USER_REPORT_PENALTY_COUNTMAX	대상은 일일 신고 누적 횟수를 초과하여 더 이상 신고 할 수 없습니다.
MSI_MACRO_USER_REPORT_REPORTED	다른 플레이어에게 신고를 받았습니다.
MSI_DECOM_NUM	%d 개 분해
MSI_RESET_CASH_EMOTION_INFO	이모션 구입 정보를 초기화했습니다.
MSI_RUNESYSTEM_ALREADY_EXIST	이미 룬 세트를 장착중입니다.
MSI_RUNESYSTEM_NOT_EXIST	룬 타블렛의 구성이 온전하지 않습니다.
MSI_RUNESYSTEM_LACK_OF_ITEM	필요 아이템이 부족합니다.
MSI_RUNESYSTEM_ALREADY_EQUIPED	장착중인 룬 세트가 있습니다. 룬 세트 해제후 시도해 주십시오. 
MSI_RUNESYSTEM_NOTHING_EQUIPED	장착중인 룬 세트가 없습니다.
MSI_RUNESYSTEM_INVALID_ID	잘못된 룬 타블렛 데이터 입니다. 잠시후 시도해 주십시오.
MSI_RUNESYSTEM_MAX_LEVEL	더 이상 강화할수 없습니다. 최대 강화도 입니다.
MSI_RUNESYSTEM_INVALID_OWNER	잘못된 룬 타블렛 데이터 입니다. 잠시후 시도해 주십시오.
MSI_RUNESYSTEM_TABLE_NOT_EXIT	잘못된 룬 타블렛 데이터 입니다. 잠시후 시도해 주십시오.
MSI_RUNESYSTEM_DB_LOAD_NOT_YET	룬 타블렛 데이터를 로딩중입니다. 잠시후 시도해 주십시오.
MSI_RUNESYSTEM_INVALID_TABLE_DATA	잘못된 룬 타블렛 데이터 입니다. 잠시후 시도해 주십시오.
MSI_RUNESYSTEM_RUNE_UI_NOT_OPENED	UI가 활성화 되지 않았습니다.
MSI_DECOM_FAIL	알 수 없는 에러입니다. 다시 시도해 주십시오.
MSI_DECOM_CANNOT_FIND_ITEM	분해하려는 아이템이 없습니다.
MSI_DECOM_NOT_ENOUGH_INVENTORY	인벤토리 공간이 충분하지 않습니다. 인벤토리 공간을 비운 후 시도해 주십시오.
MSI_DECOM_HEAVY_INVENTORY	캐릭터 무게가 너무 무겁습니다. 무게를 낮춘 후 시도해 주십시오.
MSI_DECOM_OVER_ITEM_COUNT	아이템 최대 수량(30000)이상입니다.
MSI_DECOM_RUNE_UI_NOT_OPENED	UI가 활성화 되지 않았습니다.
MSI_DECOM_TABLE_NOT_EXIT	분해 정보가 없습니다.
MSI_DECOM_NOT_ENOUGH_ITEM_COUNT	분해하려는 아이템 수량이 부족합니다.
MSI_MACRO_USER_REPORT_NOT_USE_AREA	신고가 불가능한 지역입니다.
MSI_GRAPHIC_SETTING_RENDER_SYSTEM	그래픽 API
MSI_PAY_CONFIRM_BY_ITEM	^FF2931사용된 %s 아이템은\n청약철회 대상에 포함되지\n않으며, %s로의\n재교환 역시 불가능합니다.
MSI_ENCHANT_MARK_1	D
MSI_ENCHANT_MARK_2	C
MSI_ENCHANT_MARK_3	B
MSI_ENCHANT_MARK_4	A
MSI_VIEW_COSTUME	의상 보기
MSI_SHORTCUT_SKILL_TOOLTIP_SP_PERCENT	{0} Use Lv {1} (Sp : {2}%)
MSI_SHORTCUT_SKILL_TOOLTIP_SP_VALUE	{0} Use Lv {1} (Sp : {2})
MSI_SHORTCUT_SKILL_TOOLTIP_SP_PERCENT_AP_VALUE	{0} Use Lv {1} (Sp : {2}%, Ap : {3})
MSI_SHORTCUT_SKILL_TOOLTIP_SP_VALUE_AP_VALUE	{0} Use Lv {1} (Sp : {2}, Ap : {3})
MIS_SHORTCUT_SKILL_TOOLTIP_HOTKEY_SP_PERCENT	{0} {1} Use Lv {2} (Sp : {3}%)
MSI_SHORTCUT_SKILL_TOOLTIP_HOTKEY_SP_VALUE	{0} {1} Use Lv {2} (Sp : {3})
MSI_SHORTCUT_SKILL_TOOLTIP_HOTKEY_SP_PERCENT_AP_VALUE	{0} {1} Use Lv {2} (Sp : {3}%, Ap : {4})
MSI_SHORTCUT_SKILL_TOOLTIP_HOTKEY_SP_VALUE_AP_VALUE	{0} {1} Use Lv {2} (Sp : {3}, Ap : {4})
MSI_QUESTINFOWND_QUEST_TITLE	QUEST : 
MSI_SHOW_FOOTPRINT_EFFECT	내 발자국만 보기
MSI_NO_SEARCH_RESULTS	검색 결과가 없습니다.
MSI_CHECK_PROBABILITY	확률 확인
MSI_REFINING_BLACKSMITH_BlESSING_MSG1	경고
MSI_REFINING_BLACKSMITH_BlESSING_MSG2	대장장이의 축복을 아직 적용하지 않았습니다. 강화를 계속 하시겠습니까?
MSI_REFINING_BLACKSMITH_BlESSING_MSG3	해당 장비 제련 중 다시 보지 않음
MSI_PROBABILITY_TITLE	확률 공개
MSI_COMPONENT_SEARCH	구성품 검색
MSI_PROBABILITY	확률
MSI_ITEM_HIRE_HOUR	 ({}시간)
MSI_REFINING_PROBABILITY_URL	https://probability.gnjoy.com/RO/SMELT/SMELT/0001
MSI_GRADE_ENCHANT_PROBABILITY_URL	https://probability.gnjoy.com/RO/GRADEBUILD/GRADEBUILD/0001
MSI_SELLINGSLOT_SUCCESS	신규 캐릭터 슬롯이 생성 되었습니다.
MSI_SELLINGSLOT_ERROR_SYSTEM	알 수 없는 오류로 아이템 사용에 실패 하였습니다.
MSI_SELLINGSLOT_ERROR_MAXSLOT	더 이상 캐릭터 슬롯을 확장할 수 없습니다.
MSI_ETC_PROBABILITY_URL	https://probability.gnjoy.com/
MSI_ETC_PROBABILITY_WEB_CONNECT	확률 공개 웹페이지로 이동합니다.
MSI_GENDER_CHANGE_FAILED_CAUSE_JOB	해당 직업은 아이템을 사용할 수 없습니다.
MSI_GENDER_CHANGE_FAILED_CAUSE_GROUP	파티나 길드에 소속되어 있는 경우 아이템을 사용할 수 없습니다.
MSI_GENDER_CHANGE_FAILED_CAUSE_MARRIED	결혼 상태에서는 아이템을 사용할 수 없습니다.
MSI_GENDER_CHANGE_FAILED_CAUSE_MONSTER_TRANSFORM	변신 상태에서는 성별 변경을 진행할 수 없습니다.
MSI_GENDER_CHANGE_MESSAGE_CONFIRM	캐릭터의 성별을 변경하시겠습니까?\n^ff0000파티, 길드에서 탈퇴해야 변경 가능 합니다.^000000
MSI_GENDER_CHANGE_MESSAGE_OK	성별 변경 시작
MSI_GENDER_CHANGE_MESSAGE_CANCEL	아이템 사용을 취소하였습니다.
MSI_GENDER_CHANGE_MESSAGE_COMPLETE	캐릭터의 성별이 변경되었습니다.
MSI_MACRO_CHECKER_MAP_NOT_GM	명령어 사용 권한이 없습니다.
MSI_MACRO_CHECKER_MAP_BANNED_MAP	매크로 체커를 생성할 수 없는 맵입니다.
MSI_MACRO_CHECKER_MAP_IS_COOLTIME	아직 매크로 체커를 생성할 수 없습니다.
MSI_MACRO_CHECKER_MAP_SUCCESS	해당 맵에 매크로 체커를 생성 하였습니다.
MSI_GAME_SETTINGS_TAB_BASIC	기본 설정
MSI_GAME_SETTINGS_TAB_EFFECT	이펙트 설정
MSI_GAME_SETTINGS_TAB_CONTROL	컨트롤 설정
MSI_GAME_SETTINGS_TAB_GRAPHICS	그래픽 설정
MSI_GAME_SETTINGS_EMBLEM_FRAME	엠블렘 테두리
MSI_GAME_SETTINGS_ON	켜기
MSI_GAME_SETTINGS_OFF	끄기
MSI_GAME_SETTINGS_SHOW	보이기
MSI_GAME_SETTINGS_HIDE	숨기기
MSI_GAME_SETTINGS_RODEX_SPAM_ON	임의 유저 수신 거부
MSI_GAME_SETTINGS_RODEX_SPAM_OFF	모든 유저 수신
MSI_GAME_SETTINGS_PROCESS_PRIORITY	기본 우선순위
MSI_GAME_SETTINGS_PROCESS_PRIORITY_HIGH	높음
MSI_GAME_SETTINGS_PROCESS_PRIORITY_HIGH_TOOLTIP	라그나로크 프로세스 우선 순위를 높여 게임 속도를 빠르게 합니다.
MSI_GAME_SETTINGS_PROCESS_PRIORITY_NORMAL	보통
MSI_GAME_SETTINGS_PROCESS_PRIORITY_NORMAL_TOOLTIP	라그나로크 프로세스 우선 순위를 기본 설정인 보통으로 합니다.
MSI_GAME_SETTINGS_PROCESS_PRIORITY_IDLE	낮음
MSI_GAME_SETTINGS_PROCESS_PRIORITY_IDLE_TOOLTIP	라그나로크 프로세스 우선 순위를 낮춰 타 프로그램과 함께 구동이 용이해집니다.
MSI_GAME_SETTINGS_AURA	오오라 표시
MSI_GAME_SETTINGS_SIMPLE_AURA	오오라 표현
MSI_GAME_SETTINGS_SIMPLE_AURA_OFF	오리지널
MSI_GAME_SETTINGS_SIMPLE_AURA_ON	미니 오오라
MSI_GAME_SETTINGS_DAMAGE_EXPAND	데미지 표기
MSI_GAME_SETTINGS_DAMAGE_EXPAND_ON	표기 확장
MSI_GAME_SETTINGS_DAMAGE_EXPAND_OFF	기본 보기
MSI_GAME_SETTINGS_MAP_NAME	지역 이동시
MSI_GAME_SETTINGS_MAP_NAME_ON	맵 이름 표시
MSI_GAME_SETTINGS_MAP_NAME_OFF	맵 이름 보지 않기
MSI_GAME_SETTINGS_FOG	안개 이펙트
MSI_GAME_SETTINGS_FOOTPRINT_EFFECT	발자국 이펙트
MSI_GAME_SETTINGS_FOOTPRINT_EFFECT_ALL	모두 보기
MSI_GAME_SETTINGS_SNAP	마우스 스냅
MSI_GAME_SETTINGS_SNAP_ATTACK	몬스터 타겟
MSI_GAME_SETTINGS_SNAP_SKILL	스킬 타겟
MSI_GAME_SETTINGS_SNAP_ITEM	아이템 줍기
MSI_GAME_SETTINGS_NO_CTRL	No Ctrl
MSI_GAME_SETTINGS_NO_CTRL_TEXT	몬스터 지속 공격 시, Ctrl 누르지 않음
MSI_GAME_SETTINGS_NO_SHIFT	No Shift
MSI_GAME_SETTINGS_NO_SHIFT_TEXT	회복 스킬로 몬스터 공격 시, Shift 누르지 않음
MSI_GAME_SETTINGS_ZOOM_OUT_TEXT	줌 아웃 시, 화면이 조금 더 넓게 표시됨
MSI_GAME_SETTINGS_MOUSE_EXCLUSIVE_TEXT	창 모드시, 마우스 커서가 창 밖으로 나가지 않음
MSI_GAME_SETTINGS_SCREEN_MODE	화면 모드
MSI_GAME_SETTINGS_FULLSCREEN_MODE	전체화면 모드
MSI_GAME_SETTINGS_WINDOW_MODE	창화면 모드
MSI_GAME_SETTINGS_TRILINEAR	트라이니어 필터링
MSI_MACRO_CHECKER_MAP_NOT_PROPER_MAP	명령어 사용 지역이 올바르지 않습니다.
MSI_TAREN_TRWSDK_FILTER_SENSITIVEWORDS_ERROR	인터페이스 에러 발생. 잠시 후에 재시도 해 주세요.
MSI_TAREN_TRWSDK_FILTER_NO_SEND_BECAUSE_SENSITIVEWORDS_ERROR	인터페이스 에러 발생. 전송이 중단 되었습니다.
MSI_REFUSE_SDK_AUTH_FAILED	SDK 로그인 정보 인증 실패, 잠시 후 다시 시도하세요.
MSI_CHECK_CHAR_DELETE_TEXT	캐릭터 삭제 확인
MSI_BAN_BLOCK_CHARCTER_SERVER_SECOND_PASSWORD_BR	해당 계정은 2차 비밀번호 오입력으로 인해 게임내 접속이 제한된 상태입니다. \n {2:02}/{1:02}/{0:04} {3:02}:{4:02}에 접속제한이 해제되며, 접속제한의 해제는 홈페이지 -> 개인정보변경 -> 2차 비밀번호 에서 본인인증 후 진행해주시기 바랍니다.
MSI_USESKILL_FAIL_NEED_SHOTGUN_OR_GATLING_OR_GRANADE	샷건, 개틀링건 혹은 그레네이드 런처 계열의 총기류를 장착한 상태여야 합니다.
MSI_TIPTAG_FOCUS_WARNING	>> 태그를 사용할 위치가 지정되어 있지 않습니다.
MSI_NAVIGATION_NOT_SEARCH_INMAP_MSG	Navigation >: 내부 환경 맵의 검색 지원을 하지 않습니다.
MSI_ERRORPOPUP_TITLE	error code - %08d
MSI_ERRORPOPUP_DETAIL	해당 오류코드를 스크린샷 하여\nGM 에 문의해 주시기를 바랍니다.
MSI_NAVIGATION_RS_REFAILTARGETROUTE	루트를 벗어났습니다 다시 돌아가시기 바랍니다.
MSI_RUNESYSTEM_REWARD_NOTMET	이전 보상 획득 후 획득 가능한 보상입니다.
MSI_RUNESYSTEM_REWARD_COMPLETE	이미 획득한 수집 보상입니다.
MSI_RUNESYSTEM_REWARD_EMPTY	수집 보상이 존재 하지 않습니다.
MSI_RUNESYSTEM_REWARD_FAIL	수집 보상 획득에 실패하였습니다. 
MSI_RUNESYSTEM_REWARD_TITLE	룬 세트 수집 보상
MSI_STORE_PASSWORD_ONOFF_MSG	아이템 창고 Password
MSI_CASHSHOP_PASSWORD_ONOFF_MSG	캐쉬 상점 Password
MSI_SECOND_PASSWORD_ONOFF_TIP_MSG	비번을 사용하시려면 클릭하세요
MSI_REMOVE_HEAD_COLOR	염색제거
MSI_GENDER_CHANGE_FAILED_CAUSE_RIDING	탑승 중인 상태에서는 성별 변경 아이템을 사용할 수 없습니다.
MSI_USE_ITEM_FAILED	현재 상태에서는 소비 아이템을 사용할 수 없습니다.
MSI_RUNESYSTEM_REWARD_CANNOT_FIND_ITEM	정보가 일치하지 않습니다.
MSI_RUNESYSTEM_REWARD_MAX_INVENTORY	인벤토리 공간이 충분하지 않습니다. 인벤토리 공간을 비운 후 시도해 주십시오.
MSI_RUNESYSTEM_REWARD_HEAVY_INVENTORY	무게가 초과하여 보상 획득이 불가능합니다.
MSI_RUNESYSTEM_REWARD_OVER_ITEM_COUNT	아이템 최대 수량(30000)이상입니다.
MSI_RUNESYSTEM_REWARD_RUNE_UI_NOT_OPENED	UI가 오픈되지 않았습니다.
MSI_RUNESYSTEM_REWARD_TABLE_NOT_EXIT	정보가 존재하지 않습니다.
MSI_GAME_SETTINGS_LOGINOUT	로그인 알림
MSI_GAME_SETTINGS_TAB_ETC	기타 설정
MSI_GAME_SETTINGS_FOG_ON	Fog On
MSI_GAME_SETTINGS_FOG_OFF	Fog Off
MSI_GAME_SETTINGS_EMBLEM_ON	Guild Emblem On
MSI_GAME_SETTINGS_EMBLEM_OFF	Guild Emblem Off
MSI_AUTO_HUNT_SETTINGS	자동 사냥 설정
MSI_AUTO_HUNT_MONSTER_SETTING	몬스터설정
MSI_AUTO_HUNT_SKILL_SETTING	스킬설정
MSI_AUTO_HUNT_POTION_SETTING	포션설정
MSI_AUTO_HUNT_LOOTING_SETTING	루팅설정
MSI_AUTO_HUNT_SELECT_MONSTER	몬스터를 선택하세요
MSI_AUTO_HUNT_ALL_MONSTER	모든 몬스터
MSI_AUTO_HUNT_SKILL_SETTING_DESCRIPTION	자동 전투 중에는 왼쪽부터\n순서대로 스킬을 시전합니다.
MSI_AUTO_HUNT_RECOVERY_HP	HP 회복
MSI_AUTO_HUNT_RECOVERY_HP_DESCRIPTION	HP가 <FONT COLOR = FF494B><B>50%</B></FONT> 미만일 때 자동 회복
MSI_AUTO_HUNT_RECOVERY_SP	SP 회복
MSI_AUTO_HUNT_RECOVERY_SP_DESCRIPTION	HP가 <FONT COLOR = FF494B><B>50%</B></FONT> 미만일 때 자동 회복
MSI_AUTO_HUNT_WEIGHT_SETTING	무게 설정
MSI_AUTO_HUNT_WEIGHT_SETTING_DESCRIPTION	무게가 <FONT COLOR = FF494B><B>50%</B></FONT> 미만일 때 자동 회복
MSI_OPTIMAL_ROUTE	최적 경로
MSI_AUTO_CHANGE_SIMPLE_UI	간편 UI로 자동 변경
MSI_SIMPLE_NAVIGATION	간편 내비게이션
MSI_AMENITIES_SHOW_HIDE	편의시설 보임/숨김
MSI_EXPANSION_MINIMAP	확장 미니맵
MSI_OPTION_ESC	옵션(ESC)
MSI_SELECT_QUEST	퀘스트 선택
MSI_UI_SOUND	UI 상호작용 효과음
MSI_UI_SOUND_ON	UI 상호작용 효과음 On
MSI_UI_SOUND_OFF	UI 상호작용 효과음 Off
MSI_ALREADY_SOUND_OFF	효과음이 Off 상태입니다.Off 해제하고 시도해 주세요.
MSI_EXPLAIN_UI_SOUND	/uisound : UI 상호작용 효과음 On Off
MSI_RUNESYSTEM_RUNETITLE	%s의 룬 조각
MSI_MEMORIAL_DUN_DESTROY_EXPECTED	%d초 후 메모리얼 던전이 파괴됩니다. 던전 밖으로 이동해 주세요
MSI_CANNOT_MOVE_INDOOR_MAP	실내 즉시 이동은 지원하지 않습니다.
MSI_CANNOT_RECEIVE_WEBMALL_RODEX	*웹몰 구매 상품은 해당서버에서 받을 수 없습니다.
MSI_DAMAGED_LARM	왼손 장비가
MSI_DAMAGED_RARM	오른손 장비가
MSI_SKILL_DELAY_INFO	캐스팅 정보
MSI_SKILL_DELAY_INFO_CAST_FIXED	고정
MSI_SKILL_DELAY_INFO_CAST_STAT	변동
MSI_SKILL_DELAY_INFO_GLOBAL_POST	글로벌
MSI_SKILL_DELAY_INFO_SINGLE_POST	스킬
MSI_SKILL_DELAY_INFO_CAST_SPECIAL	특수
MSI_SKILL_DELAY_INFO_TIME	%.3g초
MSI_UI_REWARD_REQUEST	보상 받기
MSI_UI_EMOTION_VIEW	보기
MSI_EQUIPMENT_PROPERTIES_TAB0	전체
MSI_EQUIPMENT_PROPERTIES_TAB1	스탯
MSI_EQUIPMENT_PROPERTIES_TAB2	어빌
MSI_EQUIPMENT_PROPERTIES_TAB3	전투
MSI_EQUIPMENT_PROPERTIES_TAB4	속성
MSI_EQUIPMENT_PROPERTIES_TAB5	종족
MSI_EQUIPMENT_PROPERTIES_TAB6	스킬
MSI_EQUIPMENT_PROPERTIES_TAB7	특수
MSI_UI_SELECT_CHARACTER	캐릭터 선택 화면으로
MSI_UI_GAMEQUIT	게임 종료 하기
MSI_UI_CONTINUE_GAME	게임으로 돌아감
MSI_UI_REBIRTH	제자리에서 부활
MSI_UI_RETURN_TO_SAVEPOINT	저장된 지역으로 이동
MSI_UI_FIRED	해고
MSI_UI_SKILL	스킬
MSI_UI_USE	사용
MSI_UI_SEARCH	찾기
MSI_UI_NAME	Name
MSI_FREE_POINT_CURRENCY	J
MSI_QUESTUI_TAB_WAITING	대기중
MSI_UI_STR	Str
MSI_UI_AGI	Agi
MSI_UI_VIT	Vit
MSI_UI_INT	Int
MSI_UI_DEX	Dex
MSI_UI_LUK	Luk
MSI_UI_ATK	Atk
MSI_UI_MATK	Matk
MSI_UI_HIT	Hit
MSI_UI_CRITICAL	Critical
MSI_UI_DEF	Def
MSI_UI_MDEF	Mdef
MSI_UI_FLEE	Flee
MSI_UI_ASPD	Aspd
MSI_UI_STATUS_POINT	Status Point
MSI_UI_GUILD	Guild
MSI_DAMAGED_HEAD	투구가
MSI_UI_WEIGHT	Weight %d%%
MSI_SELECT_LANGUAGE	Language
MSI_UI_TIP	팁
MSI_SKILL_DELAY_INFO_CASTING	캐스팅
MSI_SKILL_DELAY_INFO_COOLTIME	쿨타임
MSI_SKILL_DELAY_INFO_LEVEL	레벨
MSI_STYLING_SHOP_RODEX_TITLE	Styling Shop
MSI_AGREE	Agree
MSI_DISAGREE	Disagree
MSI_BTN_EXIT	Exit
MSI_REPLAY	Replay
MSI_NAME_UPPER	NAME
MSI_LOCK_UPPER	LOCK
MSI_NAVI_SHARE	Share
MSI_NAVI_FIND	Find
MSI_NAVI_MOVE	Move
MSI_ROOM_TITLE	방제 :
MSI_ROOM_LIMIT	인원 :
MSI_ROOM_TYPE	종류 :
MSI_ROOM_RESTRICT	공개 :
MSI_ROOM_PASSWORD	비번 :
MSI_LOGIN_ENTRY_QUEUE_NOTICE	서버가 현재 포화상태입니다.
MSI_LOGIN_ENTRY_QUEUE_POS	나의 대기 순서
MSI_LOGIN_ENTRY_QUEUE_CANCEL_WARNING	취소 시 대기 순서가 초기화됩니다.
MSI_STORE_ASSISTANT_MAX_WEIGHT	Max Weight : %3d
MSI_STORE_PASSWORD_CHANGE	Change
MSI_DEBUFF_REMOVE	디버프 해제
MSI_PENALTY_MAKE_PARTY	신고 패널티를 받은 상태에서는 파티의 가입과 생성, 몬스터로부터 경험치, 아이템 습득이 금지됩니다.
MSI_PENALTY_DEBUFF_REMOVE_NPC_ON	미니맵 내 표기된 디버프 해제 NPC는 직접 이동하여 찾아야 합니다. 순간이동 시 위치 안내가 사라집니다.
MSI_SKILL_DELAY_FLAG_DISABLE_FIXEDCASTING_REDUCTION	*해당 스킬의 고정 캐스팅은 아이템 및 스킬의 고정캐스팅 감소 옵션에 영향을 받지 않습니다.
MSI_SKILL_DELAY_FLAG_NOREDUCT	*해당 스킬의 변동 캐스팅은 스테이터스로 감소되지 않으며,\n아이템 및 스킬의 변동캐스팅 감소 옵션에 영향을 받지 않습니다.
MSI_REFINING_FAIL_ITEM_SAFE	제련 실패시 제련 수치가 유지됩니다.
MSI_SKILL_DELAY_INFO_SO_EL_ACTION	소환 중인 정령의 레벨x3초의 스킬 쿨타임이 적용됩니다.
MSI_PET_DISAPPEAR	큐펫의 친밀도가 낮아져 야생으로 돌아갔습니다.
MSI_PETINFO_ALERT	큐펫의 친밀도를 인지하기 어려워 도망갈 수 있습니다. 계속 하시겠습니까?
MSI_BROADCASTING_SPECIAL_ITEM_OBTAIN_WITH_ITEM_LINK	[%s]님이 [%s](으)로부터 %s 를 획득 했습니다.
MSI_BROADCASTING_SPECIAL_ITEM_OBTAIN2_WITH_ITEM_LINK	%s, 축하드립니다. %s 를 얻으셨습니다!
MSI_BROADCASTING_REFINING_SUCCESS_LEVEL_9_WITH_ITEM_LINK	[%s] 님이 제련을 성공하여, %s 아이템을 획득하였습니다.
MSI_BROADCASTING_REFINING_FAIL_LEVEL_9_WITH_ITEM_LINK	[%s] 님이 %s 아이템의 제련에 실패하였습니다.
MSI_BROADCASTING_GRADE_ENCHANT_SUCCESS_WITH_ITEM_LINK	[%s] 님이 등급강화를 성공하여, %s 아이템을 획득하였습니다.
MSI_BROADCASTING_GRADE_ENCHANT_FAIL_WITH_ITEM_LINK	[%s] 님이 %s 아이템의 등급강화에 실패하였습니다.
MSI_PREVIEW_EQUIP_SIT	앉기
MSI_PREVIEW_EQUIP_MOVE	걷기
MSI_PREVIEW_EQUIP_ATTACK	공격
MSI_PREVIEW_EQUIP_ATTACK_WAIT	대기
MSI_PREVIEW_EQUIP_DEAD	사망
MSI_PREVIEW_EQUIP_PICKUP	줍기
MSI_USESKILL_FAIL_NEED_EFST	스킬을 사용할 수 없는 상태입니다.
MSI_USESKILL_FAIL_NOT_EFST	변신 상태에서는 사용이 불가능합니다.
MSI_USESKILL_FAIL_DELAY_EFST	변신할 수 없는 상태입니다.
MSI_USESKILL_FAIL_NEED_TRANSFORM_W	맹수 변신 상태에서만 사용 가능합니다.
MSI_USESKILL_FAIL_NEED_TRANSFORM_R	맹금 변신 상태에서만 사용 가능합니다.
MSI_USESKILL_FAIL_COMMON_MESSAGE	스킬을 사용할 수 없습니다.
MSI_FAILED_RIDING_ON_TRANSFORM	변신 상태에서는 고삐 아이템을 사용할 수 없습니다.
MSI_PETINFO_SHOW_OPTION_ON	큐펫 정보 자동 안내 On
MSI_PETINFO_SHOW_OPTION_OFF	큐펫 정보 자동 안내 Off
MSI_RESET_SKILL_FAILED_ON_TRANSFORM	변신 상태에서는 스킬 초기화가 불가능합니다.
MSI_RESET_STAT_FAILED_ON_TRANSFORM	변신 상태에서는 스탯 초기화가 불가능합니다.
MSI_RESET_SKILL_FAILED_ON_RIDING	탑승 상태에서는 스킬 초기화가 불가능합니다.
MSI_RESET_STAT_FAILED_ON_RIDING	탑승 상태에서는 스탯 초기화가 불가능합니다.
